#,Time,Type,Order,Size,Price,Profit,Balance,Symbol
1,2009.01.07 17:47,sell,1,0.01,2.11082,,,GBPAUD
2,2009.01.07 17:51,sell,2,0.01,1.90062,,,EURAUD
3,2009.01.07 17:52,buy,3,0.01,0.85558,,,AUDCAD
4,2009.01.07 17:52,buy,4,0.01,0.78980,,,AUDCHF
5,2009.01.07 17:52,buy,5,0.01,66.8930,,,AUDJPY
6,2009.01.07 17:52,buy,6,0.01,1.20141,,,AUDNZD
7,2009.01.07 17:52,buy,7,0.01,0.72185,,,AUDUSD
8,2009.01.07 17:55,sell,8,0.01,2.10931,,,GBPAUD
9,2009.01.07 18:00,buy,9,0.01,0.85382,,,AUDCAD
10,2009.01.07 18:00,buy,10,0.01,0.78834,,,AUDCHF
11,2009.01.07 18:00,buy,11,0.01,66.6960,,,AUDJPY
12,2009.01.07 18:00,buy,12,0.01,1.19993,,,AUDNZD
13,2009.01.07 18:00,buy,13,0.01,0.71969,,,AUDUSD
14,2009.01.07 18:00,sell,14,0.01,1.90274,,,EURAUD
15,2009.01.07 18:01,sell,15,0.01,2.11960,,,GBPAUD
16,2009.01.07 18:05,sell,16,0.01,1.90319,,,EURAUD
17,2009.01.07 18:06,buy,17,0.01,0.85315,,,AUDCAD
18,2009.01.07 18:06,buy,18,0.01,0.78744,,,AUDCHF
19,2009.01.07 18:06,buy,19,0.01,66.6410,,,AUDJPY
20,2009.01.07 18:06,buy,20,0.01,1.20066,,,AUDNZD
21,2009.01.07 18:06,buy,21,0.01,0.71948,,,AUDUSD
22,2009.01.07 23:55,sell,22,0.01,1.91390,,,EURAUD
23,2009.01.07 23:55,sell,23,0.01,1.91395,,,EURAUD
24,2009.01.07 23:58,buy,24,0.01,65.9530,,,AUDJPY
25,2009.01.07 23:58,buy,25,0.01,65.9560,,,AUDJPY
26,2009.01.07 23:58,buy,26,0.01,1.20316,,,AUDNZD
27,2009.01.07 23:58,sell,27,0.01,2.11990,,,GBPAUD
28,2009.01.07 23:58,sell,28,0.01,2.11980,,,GBPAUD
29,2009.01.07 23:59,buy,29,0.01,0.85095,,,AUDCAD
30,2009.01.07 23:59,buy,30,0.01,0.78492,,,AUDCHF
31,2009.01.07 23:59,buy,31,0.01,0.78516,,,AUDCHF
32,2009.01.07 23:59,buy,32,0.01,1.20306,,,AUDNZD
33,2009.01.08 00:00,buy,33,0.01,0.85115,,,AUDCAD
34,2009.01.08 00:00,buy,34,0.01,0.71358,,,AUDUSD
35,2009.01.08 00:00,buy,35,0.01,0.71333,,,AUDUSD
36,2009.01.08 00:05,sell,36,0.01,1.91590,,,EURAUD
37,2009.01.08 00:08,buy,37,0.01,1.20406,,,AUDNZD
38,2009.01.08 00:09,sell,38,0.01,2.12224,,,GBPAUD
39,2009.01.08 00:10,buy,39,0.01,0.85014,,,AUDCAD
40,2009.01.08 00:10,buy,40,0.01,0.78449,,,AUDCHF
41,2009.01.08 00:10,buy,41,0.01,65.9510,,,AUDJPY
42,2009.01.08 00:10,buy,42,0.01,0.71215,,,AUDUSD
43,2009.01.08 06:25,sell,43,0.01,1.92440,,,EURAUD
44,2009.01.08 06:25,sell,44,0.01,1.92439,,,EURAUD
45,2009.01.08 06:26,sell,45,0.01,1.92488,,,EURAUD
46,2009.01.08 06:29,buy,46,0.01,0.84685,,,AUDCAD
47,2009.01.08 06:29,buy,47,0.01,0.78009,,,AUDCHF
48,2009.01.08 06:29,buy,48,0.01,0.78016,,,AUDCHF
49,2009.01.08 06:29,buy,49,0.01,65.4980,,,AUDJPY
50,2009.01.08 06:29,buy,50,0.01,65.4960,,,AUDJPY
51,2009.01.08 06:29,buy,51,0.01,1.20483,,,AUDNZD
52,2009.01.08 06:29,buy,52,0.01,1.20477,,,AUDNZD
53,2009.01.08 06:29,sell,53,0.01,2.12785,,,GBPAUD
54,2009.01.08 06:29,sell,54,0.01,2.12789,,,GBPAUD
55,2009.01.08 06:30,buy,55,0.01,0.84675,,,AUDCAD
56,2009.01.08 06:30,buy,56,0.01,0.70798,,,AUDUSD
57,2009.01.08 06:30,buy,57,0.01,0.70783,,,AUDUSD
58,2009.01.08 06:30,sell,58,0.01,2.12752,,,GBPAUD
59,2009.01.08 06:31,buy,59,0.01,0.84610,,,AUDCAD
60,2009.01.08 06:31,buy,60,0.01,0.78013,,,AUDCHF
61,2009.01.08 06:31,buy,61,0.01,65.4670,,,AUDJPY
62,2009.01.08 06:31,buy,62,0.01,1.20414,,,AUDNZD
63,2009.01.08 06:31,buy,63,0.01,0.70728,,,AUDUSD
64,2009.01.08 06:36,sell,64,0.01,1.92450,,,EURAUD
65,2009.01.08 06:41,buy,65,0.01,0.84489,,,AUDCAD
66,2009.01.08 06:41,buy,66,0.01,0.77837,,,AUDCHF
67,2009.01.08 06:41,buy,67,0.01,65.3810,,,AUDJPY
68,2009.01.08 06:41,buy,68,0.01,1.20220,,,AUDNZD
69,2009.01.08 06:41,buy,69,0.01,0.70626,,,AUDUSD
70,2009.01.08 06:41,sell,70,0.01,2.13122,,,GBPAUD
71,2009.01.08 06:48,sell,71,0.01,1.92976,,,EURAUD
72,2009.01.08 06:52,buy,72,0.01,0.84345,,,AUDCAD
73,2009.01.08 06:52,buy,73,0.01,0.77744,,,AUDCHF
74,2009.01.08 06:52,buy,74,0.01,65.2610,,,AUDJPY
75,2009.01.08 06:52,buy,75,0.01,1.20105,,,AUDNZD
76,2009.01.08 06:52,sell,76,0.01,2.13081,,,GBPAUD
77,2009.01.08 06:53,buy,77,0.01,0.70529,,,AUDUSD
78,2009.01.08 12:55,sell,78,0.01,2.14290,,,GBPAUD
79,2009.01.08 12:55,sell,79,0.01,2.14303,,,GBPAUD
80,2009.01.08 12:56,sell,80,0.01,2.14271,,,GBPAUD
81,2009.01.08 12:59,sell,81,0.01,1.92870,,,EURAUD
82,2009.01.08 13:00,buy,82,0.01,0.84535,,,AUDCAD
83,2009.01.08 13:00,buy,83,0.01,0.84551,,,AUDCAD
84,2009.01.08 13:00,buy,84,0.01,0.77504,,,AUDCHF
85,2009.01.08 13:00,buy,85,0.01,0.77493,,,AUDCHF
86,2009.01.08 13:00,buy,86,0.01,0.77426,,,AUDCHF
87,2009.01.08 13:00,buy,87,0.01,64.4210,,,AUDJPY
88,2009.01.08 13:00,buy,88,0.01,64.4280,,,AUDJPY
89,2009.01.08 13:00,buy,89,0.01,1.19386,,,AUDNZD
90,2009.01.08 13:00,buy,90,0.01,1.19382,,,AUDNZD
91,2009.01.08 13:00,buy,91,0.01,0.70338,,,AUDUSD
92,2009.01.08 13:00,buy,92,0.01,0.70348,,,AUDUSD
93,2009.01.08 13:00,sell,93,0.01,1.92860,,,EURAUD
94,2009.01.08 13:00,sell,94,0.01,1.93092,,,EURAUD
95,2009.01.08 13:01,buy,95,0.01,0.84545,,,AUDCAD
96,2009.01.08 13:01,buy,96,0.01,64.3620,,,AUDJPY
97,2009.01.08 13:01,buy,97,0.01,1.19351,,,AUDNZD
98,2009.01.08 13:01,buy,98,0.01,0.70282,,,AUDUSD
99,2009.01.08 13:05,sell,99,0.01,2.15285,,,GBPAUD
100,2009.01.08 13:10,buy,100,0.01,0.84421,,,AUDCAD
101,2009.01.08 13:10,buy,101,0.01,0.77535,,,AUDCHF
102,2009.01.08 13:10,buy,102,0.01,64.4780,,,AUDJPY
103,2009.01.08 13:10,buy,103,0.01,1.19367,,,AUDNZD
104,2009.01.08 13:10,buy,104,0.01,0.70333,,,AUDUSD
105,2009.01.08 13:10,sell,105,0.01,1.92971,,,EURAUD
106,2009.01.08 14:55,sell,106,0.01,2.16240,,,GBPAUD
107,2009.01.08 14:59,buy,107,0.01,0.84585,,,AUDCAD
108,2009.01.08 14:59,buy,108,0.01,1.19146,,,AUDNZD
109,2009.01.08 14:59,sell,109,0.01,1.93518,,,EURAUD
110,2009.01.08 15:00,buy,110,0.01,0.77454,,,AUDCHF
111,2009.01.08 15:00,buy,111,0.01,64.5810,,,AUDJPY
112,2009.01.08 15:00,buy,112,0.01,0.70868,,,AUDUSD
113,2009.01.08 15:19,sell,113,0.01,2.15732,,,GBPAUD
114,2009.01.08 15:24,buy,114,0.01,0.84357,,,AUDCAD
115,2009.01.08 15:24,buy,115,0.01,0.77176,,,AUDCHF
116,2009.01.08 15:24,buy,116,0.01,64.5060,,,AUDJPY
117,2009.01.08 15:24,buy,117,0.01,1.19389,,,AUDNZD
118,2009.01.08 15:24,buy,118,0.01,0.70698,,,AUDUSD
119,2009.01.08 15:24,sell,119,0.01,1.94436,,,EURAUD
120,2009.01.08 15:24,sell,120,0.01,2.16636,,,GBPAUD
121,2009.01.08 15:29,buy,121,0.01,0.84302,,,AUDCAD
122,2009.01.08 15:29,buy,122,0.01,0.77131,,,AUDCHF
123,2009.01.08 15:29,buy,123,0.01,64.4870,,,AUDJPY
124,2009.01.08 15:29,buy,124,0.01,1.19322,,,AUDNZD
125,2009.01.08 15:29,buy,125,0.01,0.70738,,,AUDUSD
126,2009.01.08 15:29,sell,126,0.01,1.94473,,,EURAUD
127,2009.01.12 08:57,sell,127,0.01,1.93125,,,EURAUD
128,2009.01.12 08:57,sell,128,0.01,1.93132,,,EURAUD
129,2009.01.12 08:57,sell,129,0.01,1.93130,,,EURAUD
130,2009.01.12 08:58,sell,130,0.01,1.93120,,,EURAUD
131,2009.01.12 09:01,sell,131,0.01,2.17709,,,GBPAUD
132,2009.01.12 09:01,sell,132,0.01,2.17697,,,GBPAUD
133,2009.01.12 09:01,sell,133,0.01,2.17684,,,GBPAUD
134,2009.01.12 09:01,sell,134,0.01,2.17672,,,GBPAUD
135,2009.01.12 09:02,buy,135,0.01,0.82820,,,AUDCAD
136,2009.01.12 09:02,buy,136,0.01,0.82815,,,AUDCAD
137,2009.01.12 09:02,buy,137,0.01,0.77424,,,AUDCHF
138,2009.01.12 09:02,buy,138,0.01,0.77428,,,AUDCHF
139,2009.01.12 09:02,buy,139,0.01,0.77433,,,AUDCHF
140,2009.01.12 09:02,buy,140,0.01,0.77431,,,AUDCHF
141,2009.01.12 09:02,buy,141,0.01,62.5530,,,AUDJPY
142,2009.01.12 09:02,buy,142,0.01,62.5560,,,AUDJPY
143,2009.01.12 09:02,buy,143,0.01,62.5480,,,AUDJPY
144,2009.01.12 09:02,buy,144,0.01,62.5510,,,AUDJPY
145,2009.01.12 09:02,buy,145,0.01,1.17909,,,AUDNZD
146,2009.01.12 09:02,buy,146,0.01,1.17907,,,AUDNZD
147,2009.01.12 09:02,buy,147,0.01,1.17905,,,AUDNZD
148,2009.01.12 09:02,buy,148,0.01,1.17903,,,AUDNZD
149,2009.01.12 09:02,buy,149,0.03,0.69408,,,AUDUSD
150,2009.01.12 09:03,buy,150,0.01,0.82825,,,AUDCAD
151,2009.01.12 09:03,buy,151,0.01,0.82832,,,AUDCAD
152,2009.01.12 09:03,buy,152,0.01,0.69398,,,AUDUSD
153,2009.01.12 13:40,sell,153,0.01,2.18153,,,GBPAUD
154,2009.01.12 13:40,sell,154,0.01,2.18156,,,GBPAUD
155,2009.01.12 13:40,sell,155,0.01,2.18158,,,GBPAUD
156,2009.01.12 13:40,sell,156,0.01,2.18161,,,GBPAUD
157,2009.01.12 13:42,sell,157,0.01,1.95175,,,EURAUD
158,2009.01.12 13:42,sell,158,0.01,1.95172,,,EURAUD
159,2009.01.12 13:42,sell,159,0.01,1.95168,,,EURAUD
160,2009.01.12 13:42,sell,160,0.01,1.95164,,,EURAUD
161,2009.01.12 13:45,buy,161,0.01,0.82535,,,AUDCAD
162,2009.01.12 13:45,buy,162,0.01,0.82532,,,AUDCAD
163,2009.01.12 13:45,buy,163,0.01,0.82529,,,AUDCAD
164,2009.01.12 13:45,buy,164,0.01,0.82525,,,AUDCAD
165,2009.01.12 13:45,buy,165,0.01,0.76928,,,AUDCHF
166,2009.01.12 13:45,buy,166,0.01,0.76922,,,AUDCHF
167,2009.01.12 13:45,buy,167,0.01,0.76933,,,AUDCHF
168,2009.01.12 13:45,buy,168,0.01,0.76944,,,AUDCHF
169,2009.01.12 13:45,buy,169,0.01,61.9650,,,AUDJPY
170,2009.01.12 13:45,buy,170,0.01,61.9630,,,AUDJPY
171,2009.01.12 13:45,buy,171,0.01,61.9610,,,AUDJPY
172,2009.01.12 13:45,buy,172,0.01,61.9590,,,AUDJPY
173,2009.01.12 13:45,buy,173,0.01,1.18407,,,AUDNZD
174,2009.01.12 13:45,buy,174,0.01,1.18410,,,AUDNZD
175,2009.01.12 13:45,buy,175,0.01,1.18409,,,AUDNZD
176,2009.01.12 13:45,buy,176,0.01,1.18408,,,AUDNZD
177,2009.01.12 13:45,buy,177,0.03,0.68912,,,AUDUSD
178,2009.01.12 13:45,buy,178,0.01,0.68909,,,AUDUSD
179,2009.01.12 14:25,sell,179,0.01,1.95184,,,EURAUD
180,2009.01.12 14:25,sell,180,0.01,2.18050,,,GBPAUD
181,2009.01.12 14:29,buy,181,0.01,0.76944,,,AUDCHF
182,2009.01.12 14:29,buy,182,0.01,61.8210,,,AUDJPY
183,2009.01.12 14:29,buy,183,0.01,1.18332,,,AUDNZD
184,2009.01.12 14:30,buy,184,0.01,0.82275,,,AUDCAD
185,2009.01.12 14:30,buy,185,0.01,0.68688,,,AUDUSD
186,2009.01.12 19:25,sell,186,0.01,2.16760,,,GBPAUD
187,2009.01.12 19:29,buy,187,0.01,0.82995,,,AUDCAD
188,2009.01.12 19:29,buy,188,0.01,0.76044,,,AUDCHF
189,2009.01.12 19:29,sell,189,0.01,1.95810,,,EURAUD
190,2009.01.12 19:30,buy,190,0.01,61.0110,,,AUDJPY
191,2009.01.12 19:30,buy,191,0.01,1.17626,,,AUDNZD
192,2009.01.12 19:30,buy,192,0.01,0.68428,,,AUDUSD
193,2009.01.12 22:38,sell,193,0.01,2.17690,,,GBPAUD
194,2009.01.12 22:38,sell,194,0.01,2.17701,,,GBPAUD
195,2009.01.12 22:40,sell,195,0.01,1.96252,,,EURAUD
196,2009.01.12 22:40,sell,196,0.01,1.96260,,,EURAUD
197,2009.01.12 22:41,buy,197,0.01,0.82931,,,AUDCAD
198,2009.01.12 22:41,buy,198,0.01,0.82935,,,AUDCAD
199,2009.01.12 22:42,buy,199,0.01,0.75853,,,AUDCHF
200,2009.01.12 22:42,buy,200,0.01,0.75861,,,AUDCHF
201,2009.01.12 22:42,buy,201,0.01,60.7120,,,AUDJPY
202,2009.01.12 22:42,buy,202,0.01,60.7100,,,AUDJPY
203,2009.01.12 22:42,buy,203,0.01,1.18105,,,AUDNZD
204,2009.01.12 22:42,buy,204,0.01,1.18112,,,AUDNZD
205,2009.01.12 22:43,buy,205,0.01,0.68114,,,AUDUSD
206,2009.01.12 22:43,buy,206,0.01,0.68111,,,AUDUSD
207,2009.01.13 11:25,sell,207,0.01,2.18520,,,GBPAUD
208,2009.01.13 11:25,sell,208,0.01,2.18521,,,GBPAUD
209,2009.01.13 11:25,sell,209,0.01,2.18522,,,GBPAUD
210,2009.01.13 11:25,sell,210,0.01,2.18523,,,GBPAUD
211,2009.01.13 11:28,sell,211,0.01,1.98116,,,EURAUD
212,2009.01.13 11:28,sell,212,0.01,1.98122,,,EURAUD
213,2009.01.13 11:28,sell,213,0.01,1.98129,,,EURAUD
214,2009.01.13 11:28,sell,214,0.01,1.98135,,,EURAUD
215,2009.01.13 11:29,buy,215,0.01,59.7310,,,AUDJPY
216,2009.01.13 11:30,buy,216,0.01,0.81895,,,AUDCAD
217,2009.01.13 11:30,buy,217,0.01,0.81899,,,AUDCAD
218,2009.01.13 11:30,buy,218,0.01,0.81903,,,AUDCAD
219,2009.01.13 11:30,buy,219,0.01,0.81906,,,AUDCAD
220,2009.01.13 11:30,buy,220,0.01,0.74914,,,AUDCHF
221,2009.01.13 11:30,buy,221,0.01,0.74916,,,AUDCHF
222,2009.01.13 11:30,buy,222,0.01,0.74918,,,AUDCHF
223,2009.01.13 11:30,buy,223,0.01,0.74920,,,AUDCHF
224,2009.01.13 11:30,buy,224,0.01,59.7210,,,AUDJPY
225,2009.01.13 11:30,buy,225,0.01,59.7280,,,AUDJPY
226,2009.01.13 11:30,buy,226,0.01,59.7270,,,AUDJPY
227,2009.01.13 11:30,buy,227,0.01,1.20616,,,AUDNZD
228,2009.01.13 11:30,buy,228,0.01,1.20614,,,AUDNZD
229,2009.01.13 11:30,buy,229,0.01,1.20611,,,AUDNZD
230,2009.01.13 11:30,buy,230,0.01,1.20609,,,AUDNZD
231,2009.01.13 11:30,buy,231,0.03,0.67178,,,AUDUSD
232,2009.01.13 11:30,buy,232,0.01,0.67174,,,AUDUSD
233,2009.01.13 13:25,sell,233,0.01,2.18160,,,GBPAUD
234,2009.01.13 13:29,buy,234,0.01,0.81833,,,AUDCAD
235,2009.01.13 13:29,buy,235,0.01,0.74724,,,AUDCHF
236,2009.01.13 13:29,buy,236,0.01,1.20526,,,AUDNZD
237,2009.01.13 13:29,sell,237,0.01,1.98645,,,EURAUD
238,2009.01.13 13:30,buy,238,0.01,59.6410,,,AUDJPY
239,2009.01.13 13:30,buy,239,0.01,0.66848,,,AUDUSD
240,2009.01.13 13:35,sell,240,0.01,2.18429,,,GBPAUD
241,2009.01.13 13:40,buy,241,0.01,0.82058,,,AUDCAD
242,2009.01.13 13:40,buy,242,0.01,0.74602,,,AUDCHF
243,2009.01.13 13:40,buy,243,0.01,59.5400,,,AUDJPY
244,2009.01.13 13:40,buy,244,0.01,1.20612,,,AUDNZD
245,2009.01.13 13:40,buy,245,0.01,0.66748,,,AUDUSD
246,2009.01.13 13:40,sell,246,0.01,1.98856,,,EURAUD
247,2009.01.13 20:55,sell,247,0.01,2.18700,,,GBPAUD
248,2009.01.13 20:55,sell,248,0.01,2.18704,,,GBPAUD
249,2009.01.13 20:59,buy,249,0.01,0.74184,,,AUDCHF
250,2009.01.13 20:59,sell,250,0.01,1.98760,,,EURAUD
251,2009.01.13 21:00,buy,251,0.01,0.81275,,,AUDCAD
252,2009.01.13 21:00,buy,252,0.01,0.81281,,,AUDCAD
253,2009.01.13 21:00,buy,253,0.01,0.74194,,,AUDCHF
254,2009.01.13 21:00,buy,254,0.01,59.0510,,,AUDJPY
255,2009.01.13 21:00,buy,255,0.01,59.0500,,,AUDJPY
256,2009.01.13 21:00,buy,256,0.01,1.20106,,,AUDNZD
257,2009.01.13 21:00,buy,257,0.01,1.20116,,,AUDNZD
258,2009.01.13 21:00,buy,258,0.01,0.66268,,,AUDUSD
259,2009.01.13 21:00,buy,259,0.01,0.66273,,,AUDUSD
260,2009.01.13 21:00,sell,260,0.01,1.98770,,,EURAUD
261,2009.01.13 21:01,sell,261,0.01,2.18604,,,GBPAUD
262,2009.01.13 21:06,buy,262,0.01,0.81275,,,AUDCAD
263,2009.01.13 21:06,buy,263,0.01,0.74104,,,AUDCHF
264,2009.01.13 21:06,buy,264,0.01,58.9370,,,AUDJPY
265,2009.01.13 21:06,buy,265,0.01,1.20244,,,AUDNZD
266,2009.01.13 21:06,buy,266,0.01,0.66189,,,AUDUSD
267,2009.01.13 21:06,sell,267,0.01,1.98910,,,EURAUD
268,2009.01.14 19:21,sell,268,0.01,2.20712,,,GBPAUD
269,2009.01.14 19:25,sell,269,0.01,1.99407,,,EURAUD
270,2009.01.14 19:26,buy,270,0.01,0.82088,,,AUDCAD
271,2009.01.14 19:26,buy,271,0.01,0.73805,,,AUDCHF
272,2009.01.14 19:26,buy,272,0.01,58.8150,,,AUDJPY
273,2009.01.14 19:26,buy,273,0.01,1.21881,,,AUDNZD
274,2009.01.14 19:26,buy,274,0.01,0.65993,,,AUDUSD
275,2009.01.14 23:04,sell,275,0.01,2.21023,,,GBPAUD
276,2009.01.14 23:09,buy,276,0.01,0.82395,,,AUDCAD
277,2009.01.14 23:09,buy,277,0.01,0.73619,,,AUDCHF
278,2009.01.14 23:09,buy,278,0.01,58.6530,,,AUDJPY
279,2009.01.14 23:09,buy,279,0.01,1.21676,,,AUDNZD
280,2009.01.14 23:09,buy,280,0.01,0.65988,,,AUDUSD
281,2009.01.14 23:09,sell,281,0.01,1.99756,,,EURAUD
282,2009.01.20 11:25,close,275,0.01,2.11040,103.52,10103.52,GBPAUD
283,2009.01.20 11:25,close,268,0.01,2.11040,100.32,10203.84,GBPAUD
284,2009.01.20 11:25,close,261,0.01,2.11040,78.68,10282.52,GBPAUD
285,2009.01.20 11:25,close,248,0.01,2.11040,79.71,10362.23,GBPAUD
286,2009.01.20 11:25,close,247,0.01,2.11040,79.67,10441.90,GBPAUD
287,2009.01.20 11:25,close,240,0.01,2.11040,76.88,10518.78,GBPAUD
288,2009.01.20 11:25,close,233,0.01,2.11040,74.10,10592.88,GBPAUD
289,2009.01.20 11:25,close,210,0.01,2.11040,77.85,10670.73,GBPAUD
290,2009.01.20 11:25,close,209,0.01,2.11040,77.84,10748.57,GBPAUD
291,2009.01.20 11:25,close,208,0.01,2.11040,77.83,10826.40,GBPAUD
292,2009.01.20 11:25,close,207,0.01,2.11040,77.82,10904.22,GBPAUD
293,2009.01.20 11:25,close,194,0.01,2.11040,69.47,10973.69,GBPAUD
294,2009.01.20 11:25,close,193,0.01,2.11040,69.36,11043.05,GBPAUD
295,2009.01.20 11:25,close,186,0.01,2.11040,59.77,11102.82,GBPAUD
296,2009.01.20 11:25,close,180,0.01,2.11040,73.07,11175.89,GBPAUD
297,2009.01.20 11:25,close,156,0.01,2.11040,74.21,11250.10,GBPAUD
298,2009.01.20 11:25,close,155,0.01,2.11040,74.18,11324.28,GBPAUD
299,2009.01.20 11:25,close,154,0.01,2.11040,74.16,11398.44,GBPAUD
300,2009.01.20 11:25,close,153,0.01,2.11040,74.13,11472.57,GBPAUD
301,2009.01.20 11:25,close,134,0.01,2.11040,69.17,11541.74,GBPAUD
302,2009.01.20 11:25,close,133,0.01,2.11040,69.30,11611.04,GBPAUD
303,2009.01.20 11:25,close,132,0.01,2.11040,69.43,11680.47,GBPAUD
304,2009.01.20 11:25,close,131,0.01,2.11040,69.55,11750.02,GBPAUD
305,2009.01.20 11:25,close,120,0.01,2.11040,58.69,11808.71,GBPAUD
306,2009.01.20 11:25,close,113,0.01,2.11040,49.37,11858.08,GBPAUD
307,2009.01.20 11:25,close,106,0.01,2.11040,54.61,11912.69,GBPAUD
308,2009.01.20 11:25,close,99,0.01,2.11040,44.76,11957.45,GBPAUD
309,2009.01.20 11:25,close,80,0.01,2.11040,34.30,11991.75,GBPAUD
310,2009.01.20 11:25,close,79,0.01,2.11040,34.63,12026.38,GBPAUD
311,2009.01.20 11:25,close,78,0.01,2.11040,34.50,12060.88,GBPAUD
312,2009.01.20 11:25,close,76,0.01,2.11040,22.03,12082.91,GBPAUD
313,2009.01.20 11:25,close,70,0.01,2.11040,22.45,12105.36,GBPAUD
314,2009.01.20 11:25,close,58,0.01,2.11040,18.64,12124.00,GBPAUD
315,2009.01.20 11:25,close,54,0.01,2.11040,19.02,12143.02,GBPAUD
316,2009.01.20 11:25,close,53,0.01,2.11040,18.98,12162.00,GBPAUD
317,2009.01.20 11:25,close,38,0.01,2.11040,13.20,12175.20,GBPAUD
318,2009.01.20 11:25,close,28,0.01,2.11040,10.98,12186.18,GBPAUD
319,2009.01.20 11:25,close,27,0.01,2.11040,11.08,12197.26,GBPAUD
320,2009.01.20 11:25,close,15,0.01,2.11040,10.77,12208.03,GBPAUD
321,2009.01.20 11:25,close,8,0.01,2.11040,0.16,12208.19,GBPAUD
322,2009.01.20 11:25,close,1,0.01,2.11040,1.72,12209.91,GBPAUD
323,2009.01.20 11:29,close,277,0.01,0.75750,23.17,12233.08,AUDCHF
324,2009.01.20 11:29,close,271,0.01,0.75750,21.19,12254.27,AUDCHF
325,2009.01.20 11:29,close,263,0.01,0.75750,18.05,12272.32,AUDCHF
326,2009.01.20 11:29,close,253,0.01,0.75750,17.09,12289.41,AUDCHF
327,2009.01.20 11:29,close,249,0.01,0.75750,17.19,12306.60,AUDCHF
328,2009.01.20 11:29,close,242,0.01,0.75750,12.73,12319.33,AUDCHF
329,2009.01.20 11:29,close,235,0.01,0.75750,11.42,12330.75,AUDCHF
330,2009.01.20 11:29,close,223,0.01,0.75750,9.33,12340.08,AUDCHF
331,2009.01.20 11:29,close,222,0.01,0.75750,9.35,12349.43,AUDCHF
332,2009.01.20 11:29,close,221,0.01,0.75750,9.37,12358.80,AUDCHF
333,2009.01.20 11:29,close,220,0.01,0.75750,9.39,12368.19,AUDCHF
334,2009.01.20 11:29,close,200,0.01,0.75750,-0.67,12367.52,AUDCHF
335,2009.01.20 11:29,close,199,0.01,0.75750,-0.59,12366.93,AUDCHF
336,2009.01.20 11:29,close,188,0.01,0.75750,-2.63,12364.30,AUDCHF
337,2009.01.20 11:29,close,181,0.01,0.75750,-12.25,12352.05,AUDCHF
338,2009.01.20 11:29,close,168,0.01,0.75750,-12.25,12339.80,AUDCHF
339,2009.01.20 11:29,close,167,0.01,0.75750,-12.13,12327.67,AUDCHF
340,2009.01.20 11:29,close,166,0.01,0.75750,-12.02,12315.65,AUDCHF
341,2009.01.20 11:29,close,165,0.01,0.75750,-12.08,12303.57,AUDCHF
342,2009.01.20 11:29,close,140,0.01,0.75750,-17.46,12286.11,AUDCHF
343,2009.01.20 11:29,close,139,0.01,0.75750,-17.48,12268.63,AUDCHF
344,2009.01.20 11:29,close,138,0.01,0.75750,-17.43,12251.20,AUDCHF
345,2009.01.20 11:29,close,137,0.01,0.75750,-17.38,12233.82,AUDCHF
346,2009.01.20 11:29,close,122,0.01,0.75750,-14.12,12219.70,AUDCHF
347,2009.01.20 11:29,close,115,0.01,0.75750,-14.60,12205.10,AUDCHF
348,2009.01.20 11:29,close,110,0.01,0.75750,-17.57,12187.53,AUDCHF
349,2009.01.20 11:29,close,101,0.01,0.75750,-18.44,12169.09,AUDCHF
350,2009.01.20 11:29,close,86,0.01,0.75750,-17.27,12151.82,AUDCHF
351,2009.01.20 11:29,close,85,0.01,0.75750,-17.99,12133.83,AUDCHF
352,2009.01.20 11:29,close,84,0.01,0.75750,-18.11,12115.72,AUDCHF
353,2009.01.20 11:29,close,73,0.01,0.75750,-20.67,12095.05,AUDCHF
354,2009.01.20 11:29,close,66,0.01,0.75750,-21.67,12073.38,AUDCHF
355,2009.01.20 11:29,close,60,0.01,0.75750,-23.55,12049.83,AUDCHF
356,2009.01.20 11:29,close,48,0.01,0.75750,-23.58,12026.25,AUDCHF
357,2009.01.20 11:29,close,47,0.01,0.75750,-23.51,12002.74,AUDCHF
358,2009.01.20 11:29,close,40,0.01,0.75750,-28.21,11974.53,AUDCHF
359,2009.01.20 11:29,close,31,0.01,0.75750,-28.74,11945.79,AUDCHF
360,2009.01.20 11:29,close,30,0.01,0.75750,-28.48,11917.31,AUDCHF
361,2009.01.20 11:29,close,18,0.01,0.75750,-31.17,11886.14,AUDCHF
362,2009.01.20 11:29,close,10,0.01,0.75750,-32.14,11854.00,AUDCHF
363,2009.01.20 11:29,close,4,0.01,0.75750,-33.70,11820.30,AUDCHF
364,2009.01.20 11:29,close,279,0.01,1.24480,23.92,11844.22,AUDNZD
365,2009.01.20 11:29,close,273,0.01,1.24480,22.17,11866.39,AUDNZD
366,2009.01.20 11:29,close,265,0.01,1.24480,36.15,11902.54,AUDNZD
367,2009.01.20 11:29,close,257,0.01,1.24480,37.24,11939.78,AUDNZD
368,2009.01.20 11:29,close,256,0.01,1.24480,37.33,11977.11,AUDNZD
369,2009.01.20 11:29,close,244,0.01,1.24480,33.01,12010.12,AUDNZD
370,2009.01.20 11:29,close,236,0.01,1.24480,33.74,12043.86,AUDNZD
371,2009.01.20 11:29,close,230,0.01,1.24480,33.03,12076.89,AUDNZD
372,2009.01.20 11:29,close,229,0.01,1.24480,33.02,12109.91,AUDNZD
373,2009.01.20 11:29,close,228,0.01,1.24480,32.99,12142.90,AUDNZD
374,2009.01.20 11:29,close,227,0.01,1.24480,32.97,12175.87,AUDNZD
375,2009.01.20 11:29,close,204,0.01,1.24480,54.35,12230.22,AUDNZD
376,2009.01.20 11:29,close,203,0.01,1.24480,54.41,12284.63,AUDNZD
377,2009.01.20 11:29,close,191,0.01,1.24480,58.50,12343.13,AUDNZD
378,2009.01.20 11:29,close,183,0.01,1.24480,52.47,12395.60,AUDNZD
379,2009.01.20 11:29,close,176,0.01,1.24480,51.82,12447.42,AUDNZD
380,2009.01.20 11:29,close,175,0.01,1.24480,51.82,12499.24,AUDNZD
381,2009.01.20 11:29,close,174,0.01,1.24480,51.81,12551.05,AUDNZD
382,2009.01.20 11:29,close,173,0.01,1.24480,51.83,12602.88,AUDNZD
383,2009.01.20 11:29,close,148,0.01,1.24480,56.14,12659.02,AUDNZD
384,2009.01.20 11:29,close,147,0.01,1.24480,56.12,12715.14,AUDNZD
385,2009.01.20 11:29,close,146,0.01,1.24480,56.10,12771.24,AUDNZD
386,2009.01.20 11:29,close,145,0.01,1.24480,56.08,12827.32,AUDNZD
387,2009.01.20 11:29,close,124,0.01,1.24480,44.01,12871.33,AUDNZD
388,2009.01.20 11:29,close,117,0.01,1.24480,43.44,12914.77,AUDNZD
389,2009.01.20 11:29,close,108,0.01,1.24480,45.51,12960.28,AUDNZD
390,2009.01.20 11:29,close,103,0.01,1.24480,43.63,13003.91,AUDNZD
391,2009.01.20 11:29,close,97,0.01,1.24480,43.76,13047.67,AUDNZD
392,2009.01.20 11:29,close,90,0.01,1.24480,43.50,13091.17,AUDNZD
393,2009.01.20 11:29,close,89,0.01,1.24480,43.46,13134.63,AUDNZD
394,2009.01.20 11:29,close,75,0.01,1.24480,37.33,13171.96,AUDNZD
395,2009.01.20 11:29,close,68,0.01,1.24480,36.34,13208.30,AUDNZD
396,2009.01.20 11:29,close,62,0.01,1.24480,34.69,13242.99,AUDNZD
397,2009.01.20 11:29,close,52,0.01,1.24480,34.15,13277.14,AUDNZD
398,2009.01.20 11:29,close,51,0.01,1.24480,34.10,13311.24,AUDNZD
399,2009.01.20 11:29,close,37,0.01,1.24480,34.76,13346.00,AUDNZD
400,2009.01.20 11:29,close,32,0.01,1.24480,35.61,13381.61,AUDNZD
401,2009.01.20 11:29,close,26,0.01,1.24480,35.52,13417.13,AUDNZD
402,2009.01.20 11:29,close,20,0.01,1.24480,37.66,13454.79,AUDNZD
403,2009.01.20 11:29,close,12,0.01,1.24480,38.28,13493.07,AUDNZD
404,2009.01.20 11:29,close,6,0.01,1.24480,37.02,13530.09,AUDNZD
405,2009.01.20 11:29,close,281,0.01,1.95513,44.34,13574.43,EURAUD
406,2009.01.20 11:29,close,269,0.01,1.95513,40.75,13615.18,EURAUD
407,2009.01.20 11:29,close,267,0.01,1.95513,35.71,13650.89,EURAUD
408,2009.01.20 11:29,close,260,0.01,1.95513,34.27,13685.16,EURAUD
409,2009.01.20 11:29,close,250,0.01,1.95513,34.16,13719.32,EURAUD
410,2009.01.20 11:29,close,246,0.01,1.95513,35.15,13754.47,EURAUD
411,2009.01.20 11:29,close,237,0.01,1.95513,32.98,13787.45,EURAUD
412,2009.01.20 11:29,close,214,0.01,1.95513,27.72,13815.17,EURAUD
413,2009.01.20 11:29,close,213,0.01,1.95513,27.66,13842.83,EURAUD
414,2009.01.20 11:29,close,212,0.01,1.95513,27.59,13870.42,EURAUD
415,2009.01.20 11:29,close,211,0.01,1.95513,27.52,13897.94,EURAUD
416,2009.01.20 11:29,close,196,0.01,1.95513,8.49,13906.43,EURAUD
417,2009.01.20 11:29,close,195,0.01,1.95513,8.40,13914.83,EURAUD
418,2009.01.20 11:29,close,189,0.01,1.95513,3.85,13918.68,EURAUD
419,2009.01.20 11:29,close,179,0.01,1.95513,-2.61,13916.07,EURAUD
420,2009.01.20 11:29,close,160,0.01,1.95513,-2.82,13913.25,EURAUD
421,2009.01.20 11:29,close,159,0.01,1.95513,-2.77,13910.48,EURAUD
422,2009.01.20 11:29,close,158,0.01,1.95513,-2.73,13907.75,EURAUD
423,2009.01.20 11:29,close,157,0.01,1.95513,-2.70,13905.05,EURAUD
424,2009.01.20 11:29,close,130,0.01,1.95513,-23.89,13881.16,EURAUD
425,2009.01.20 11:29,close,129,0.01,1.95513,-23.79,13857.37,EURAUD
426,2009.01.20 11:29,close,128,0.01,1.95513,-23.77,13833.60,EURAUD
427,2009.01.20 11:29,close,127,0.01,1.95513,-23.84,13809.76,EURAUD
428,2009.01.20 11:29,close,126,0.01,1.95513,-9.74,13800.02,EURAUD
429,2009.01.20 11:29,close,119,0.01,1.95513,-10.12,13789.90,EURAUD
430,2009.01.20 11:29,close,109,0.01,1.95513,-19.59,13770.31,EURAUD
431,2009.01.20 11:29,close,105,0.01,1.95513,-25.23,13745.08,EURAUD
432,2009.01.20 11:29,close,94,0.01,1.95513,-23.98,13721.10,EURAUD
433,2009.01.20 11:29,close,93,0.01,1.95513,-26.37,13694.73,EURAUD
434,2009.01.20 11:29,close,81,0.01,1.95513,-26.27,13668.46,EURAUD
435,2009.01.20 11:29,close,71,0.01,1.95513,-25.18,13643.28,EURAUD
436,2009.01.20 11:29,close,64,0.01,1.95513,-30.60,13612.68,EURAUD
437,2009.01.20 11:29,close,45,0.01,1.95513,-30.21,13582.47,EURAUD
438,2009.01.20 11:29,close,44,0.01,1.95513,-30.71,13551.76,EURAUD
439,2009.01.20 11:29,close,43,0.01,1.95513,-30.70,13521.06,EURAUD
440,2009.01.20 11:29,close,36,0.01,1.95513,-39.47,13481.59,EURAUD
441,2009.01.20 11:29,close,23,0.01,1.95513,-41.19,13440.40,EURAUD
442,2009.01.20 11:29,close,22,0.01,1.95513,-41.24,13399.16,EURAUD
443,2009.01.20 11:29,close,16,0.01,1.95513,-52.28,13346.88,EURAUD
444,2009.01.20 11:29,close,14,0.01,1.95513,-52.75,13294.13,EURAUD
445,2009.01.20 11:29,close,2,0.01,1.95513,-54.93,13239.20,EURAUD
446,2009.01.20 11:30,close,276,0.01,0.83410,10.32,13249.52,AUDCAD
447,2009.01.20 11:30,close,270,0.01,0.83410,13.37,13262.89,AUDCAD
448,2009.01.20 11:30,close,262,0.01,0.83410,21.47,13284.36,AUDCAD
449,2009.01.20 11:30,close,252,0.01,0.83410,21.41,13305.77,AUDCAD
450,2009.01.20 11:30,close,251,0.01,0.83410,21.47,13327.24,AUDCAD
451,2009.01.20 11:30,close,241,0.01,0.83410,13.70,13340.94,AUDCAD
452,2009.01.20 11:30,close,234,0.01,0.83410,15.93,13356.87,AUDCAD
453,2009.01.20 11:30,close,219,0.01,0.83410,15.21,13372.08,AUDCAD
454,2009.01.20 11:30,close,218,0.01,0.83410,15.24,13387.32,AUDCAD
455,2009.01.20 11:30,close,217,0.01,0.83410,15.28,13402.60,AUDCAD
456,2009.01.20 11:30,close,216,0.01,0.83410,15.32,13417.92,AUDCAD
457,2009.01.20 11:30,close,198,0.01,0.83410,5.05,13422.97,AUDCAD
458,2009.01.20 11:30,close,197,0.01,0.83410,5.09,13428.06,AUDCAD
459,2009.01.20 11:30,close,187,0.01,0.83410,4.45,13432.51,AUDCAD
460,2009.01.20 11:30,close,184,0.01,0.83410,11.59,13444.10,AUDCAD
461,2009.01.20 11:30,close,164,0.01,0.83410,9.11,13453.21,AUDCAD
462,2009.01.20 11:30,close,163,0.01,0.83410,9.07,13462.28,AUDCAD
463,2009.01.20 11:30,close,162,0.01,0.83410,9.04,13471.32,AUDCAD
464,2009.01.20 11:30,close,161,0.01,0.83410,9.01,13480.33,AUDCAD
465,2009.01.20 11:30,close,151,0.01,0.83410,6.07,13486.40,AUDCAD
466,2009.01.20 11:30,close,150,0.01,0.83410,6.14,13492.54,AUDCAD
467,2009.01.20 11:30,close,136,0.01,0.83410,6.24,13498.78,AUDCAD
468,2009.01.20 11:30,close,135,0.01,0.83410,6.19,13504.97,AUDCAD
469,2009.01.20 11:30,close,121,0.01,0.83410,-8.42,13496.55,AUDCAD
470,2009.01.20 11:30,close,114,0.01,0.83410,-8.96,13487.59,AUDCAD
471,2009.01.20 11:30,close,107,0.01,0.83410,-11.22,13476.37,AUDCAD
472,2009.01.20 11:30,close,100,0.01,0.83410,-9.60,13466.77,AUDCAD
473,2009.01.20 11:30,close,95,0.01,0.83410,-10.82,13455.95,AUDCAD
474,2009.01.20 11:30,close,83,0.01,0.83410,-10.88,13445.07,AUDCAD
475,2009.01.20 11:30,close,82,0.01,0.83410,-10.73,13434.34,AUDCAD
476,2009.01.20 11:30,close,72,0.01,0.83410,-8.84,13425.50,AUDCAD
477,2009.01.20 11:30,close,65,0.01,0.83410,-10.27,13415.23,AUDCAD
478,2009.01.20 11:30,close,59,0.01,0.83410,-11.47,13403.76,AUDCAD
479,2009.01.20 11:30,close,55,0.01,0.83410,-12.11,13391.65,AUDCAD
480,2009.01.20 11:30,close,46,0.01,0.83410,-12.21,13379.44,AUDCAD
481,2009.01.20 11:30,close,39,0.01,0.83410,-15.47,13363.97,AUDCAD
482,2009.01.20 11:30,close,33,0.01,0.83410,-16.48,13347.49,AUDCAD
483,2009.01.20 11:30,close,29,0.01,0.83410,-16.16,13331.33,AUDCAD
484,2009.01.20 11:30,close,17,0.01,0.83410,-18.34,13312.99,AUDCAD
485,2009.01.20 11:30,close,9,0.01,0.83410,-19.00,13293.99,AUDCAD
486,2009.01.20 11:30,close,3,0.01,0.83410,-20.75,13273.24,AUDCAD
487,2009.01.20 11:30,close,280,0.01,0.66330,3.81,13277.05,AUDUSD
488,2009.01.20 11:30,close,274,0.01,0.66330,3.76,13280.81,AUDUSD
489,2009.01.20 11:30,close,266,0.01,0.66330,1.87,13282.68,AUDUSD
490,2009.01.20 11:30,close,259,0.01,0.66330,1.02,13283.70,AUDUSD
491,2009.01.20 11:30,close,258,0.01,0.66330,1.08,13284.78,AUDUSD
492,2009.01.20 11:30,close,245,0.01,0.66330,-3.72,13281.06,AUDUSD
493,2009.01.20 11:30,close,239,0.01,0.66330,-4.72,13276.34,AUDUSD
494,2009.01.20 11:30,close,232,0.01,0.66330,-7.98,13268.36,AUDUSD
495,2009.01.20 11:30,close,231,0.03,0.66330,-24.08,13244.28,AUDUSD
496,2009.01.20 11:30,close,206,0.01,0.66330,-17.29,13226.99,AUDUSD
497,2009.01.20 11:30,close,205,0.01,0.66330,-17.32,13209.67,AUDUSD
498,2009.01.20 11:30,close,192,0.01,0.66330,-20.46,13189.21,AUDUSD
499,2009.01.20 11:30,close,185,0.01,0.66330,-23.06,13166.15,AUDUSD
500,2009.01.20 11:30,close,178,0.01,0.66330,-25.27,13140.88,AUDUSD
501,2009.01.20 11:30,close,177,0.03,0.66330,-75.90,13064.98,AUDUSD
502,2009.01.20 11:30,close,152,0.01,0.66330,-30.16,13034.82,AUDUSD
503,2009.01.20 11:30,close,149,0.03,0.66330,-90.78,12944.04,AUDUSD
504,2009.01.20 11:30,close,125,0.01,0.66330,-43.43,12900.61,AUDUSD
505,2009.01.20 11:30,close,118,0.01,0.66330,-43.03,12857.58,AUDUSD
506,2009.01.20 11:30,close,112,0.01,0.66330,-44.73,12812.85,AUDUSD
507,2009.01.20 11:30,close,104,0.01,0.66330,-39.38,12773.47,AUDUSD
508,2009.01.20 11:30,close,98,0.01,0.66330,-38.87,12734.60,AUDUSD
509,2009.01.20 11:30,close,92,0.01,0.66330,-39.53,12695.07,AUDUSD
510,2009.01.20 11:30,close,91,0.01,0.66330,-39.43,12655.64,AUDUSD
511,2009.01.20 11:30,close,77,0.01,0.66330,-41.34,12614.30,AUDUSD
512,2009.01.20 11:30,close,69,0.01,0.66330,-42.31,12571.99,AUDUSD
513,2009.01.20 11:30,close,63,0.01,0.66330,-43.33,12528.66,AUDUSD
514,2009.01.20 11:30,close,57,0.01,0.66330,-43.88,12484.78,AUDUSD
515,2009.01.20 11:30,close,56,0.01,0.66330,-44.03,12440.75,AUDUSD
516,2009.01.20 11:30,close,42,0.01,0.66330,-48.20,12392.55,AUDUSD
517,2009.01.20 11:30,close,35,0.01,0.66330,-49.38,12343.17,AUDUSD
518,2009.01.20 11:30,close,34,0.01,0.66330,-49.63,12293.54,AUDUSD
519,2009.01.20 11:30,close,21,0.01,0.66330,-55.34,12238.20,AUDUSD
520,2009.01.20 11:30,close,13,0.01,0.66330,-55.55,12182.65,AUDUSD
521,2009.01.20 11:30,close,7,0.01,0.66330,-57.70,12124.95,AUDUSD
522,2009.01.20 22:55,buy,282,0.01,1.24266,,,AUDNZD
523,2009.01.20 22:55,buy,283,0.01,1.24267,,,AUDNZD
524,2009.01.20 22:55,buy,284,0.01,1.24268,,,AUDNZD
525,2009.01.20 22:55,buy,285,0.01,1.24271,,,AUDNZD
526,2009.01.20 22:55,buy,286,0.01,1.24274,,,AUDNZD
527,2009.01.20 22:55,buy,287,0.01,1.24277,,,AUDNZD
528,2009.01.20 22:55,buy,288,0.01,1.24280,,,AUDNZD
529,2009.01.20 22:55,buy,289,0.01,1.24275,,,AUDNZD
530,2009.01.20 22:55,buy,290,0.01,1.24270,,,AUDNZD
531,2009.01.20 22:55,buy,291,0.01,1.24266,,,AUDNZD
532,2009.01.20 22:55,buy,292,0.01,1.24261,,,AUDNZD
533,2009.01.20 22:55,buy,293,0.01,1.24256,,,AUDNZD
534,2009.01.20 22:55,buy,294,0.01,1.24271,,,AUDNZD
535,2009.01.20 22:55,buy,295,0.01,1.24286,,,AUDNZD
536,2009.01.20 22:55,buy,296,0.01,1.24300,,,AUDNZD
537,2009.01.20 22:55,buy,297,0.01,1.24315,,,AUDNZD
538,2009.01.20 22:55,buy,298,0.01,1.24313,,,AUDNZD
539,2009.01.20 22:55,buy,299,0.01,1.24310,,,AUDNZD
540,2009.01.20 22:55,buy,300,0.01,1.24308,,,AUDNZD
541,2009.01.20 22:55,sell,301,0.01,1.98393,,,EURAUD
542,2009.01.20 22:55,sell,302,0.01,1.98373,,,EURAUD
543,2009.01.20 22:55,sell,303,0.01,1.98354,,,EURAUD
544,2009.01.20 22:55,sell,304,0.01,1.98360,,,EURAUD
545,2009.01.20 22:55,sell,305,0.01,1.98366,,,EURAUD
546,2009.01.20 22:55,sell,306,0.01,1.98371,,,EURAUD
547,2009.01.20 22:55,sell,307,0.01,1.98377,,,EURAUD
548,2009.01.20 22:55,sell,308,0.01,1.98383,,,EURAUD
549,2009.01.20 22:55,sell,309,0.01,1.98360,,,EURAUD
550,2009.01.20 22:55,sell,310,0.01,1.98336,,,EURAUD
551,2009.01.20 22:55,sell,311,0.01,1.98313,,,EURAUD
552,2009.01.20 22:55,sell,312,0.01,1.98289,,,EURAUD
553,2009.01.20 22:55,sell,313,0.01,1.98266,,,EURAUD
554,2009.01.20 22:55,sell,314,0.01,1.98272,,,EURAUD
555,2009.01.20 22:55,sell,315,0.01,1.98278,,,EURAUD
556,2009.01.20 22:55,sell,316,0.01,1.98283,,,EURAUD
557,2009.01.20 22:55,sell,317,0.01,1.98289,,,EURAUD
558,2009.01.20 22:55,sell,318,0.01,1.98295,,,EURAUD
559,2009.01.20 22:55,sell,319,0.01,1.98271,,,EURAUD
560,2009.01.20 22:55,sell,320,0.01,2.13821,,,GBPAUD
561,2009.01.20 22:55,sell,321,0.01,2.13920,,,GBPAUD
562,2009.01.20 22:56,sell,322,0.01,2.13940,,,GBPAUD
563,2009.01.20 22:56,sell,323,0.01,2.13925,,,GBPAUD
564,2009.01.20 22:56,sell,324,0.01,2.13929,,,GBPAUD
565,2009.01.20 22:56,sell,325,0.01,2.13915,,,GBPAUD
566,2009.01.20 22:56,sell,326,0.01,2.13900,,,GBPAUD
567,2009.01.20 22:56,sell,327,0.01,2.13907,,,GBPAUD
568,2009.01.20 22:56,sell,328,0.01,2.13920,,,GBPAUD
569,2009.01.20 22:57,buy,329,0.01,1.24379,,,AUDNZD
570,2009.01.20 22:57,sell,330,0.01,1.98364,,,EURAUD
571,2009.01.20 22:57,sell,331,0.01,2.13900,,,GBPAUD
572,2009.01.20 22:57,sell,332,0.01,2.13917,,,GBPAUD
573,2009.01.20 22:57,sell,333,0.01,2.13933,,,GBPAUD
574,2009.01.20 22:57,sell,334,0.01,2.13950,,,GBPAUD
575,2009.01.20 22:57,sell,335,0.01,2.13947,,,GBPAUD
576,2009.01.20 22:57,sell,336,0.01,2.13943,,,GBPAUD
577,2009.01.20 22:57,sell,337,0.01,2.13940,,,GBPAUD
578,2009.01.20 22:57,sell,338,0.01,2.13947,,,GBPAUD
579,2009.01.20 22:57,sell,339,0.01,2.13953,,,GBPAUD
580,2009.01.20 22:57,sell,340,0.01,2.13960,,,GBPAUD
581,2009.01.20 22:58,buy,341,0.01,0.74624,,,AUDCHF
582,2009.01.20 22:58,sell,342,0.01,2.13750,,,GBPAUD
583,2009.01.20 22:59,buy,343,0.01,0.82529,,,AUDCAD
584,2009.01.20 22:59,buy,344,0.01,0.82532,,,AUDCAD
585,2009.01.20 22:59,buy,345,0.01,0.82535,,,AUDCAD
586,2009.01.20 22:59,buy,346,0.01,0.82539,,,AUDCAD
587,2009.01.20 22:59,buy,347,0.01,0.82542,,,AUDCAD
588,2009.01.20 22:59,buy,348,0.01,0.82545,,,AUDCAD
589,2009.01.20 22:59,buy,349,0.01,0.82537,,,AUDCAD
590,2009.01.20 22:59,buy,350,0.01,0.82529,,,AUDCAD
591,2009.01.20 22:59,buy,351,0.01,0.82520,,,AUDCAD
592,2009.01.20 22:59,buy,352,0.01,0.82512,,,AUDCAD
593,2009.01.20 22:59,buy,353,0.01,0.82514,,,AUDCAD
594,2009.01.20 22:59,buy,354,0.01,0.82515,,,AUDCAD
595,2009.01.20 22:59,buy,355,0.01,0.82517,,,AUDCAD
596,2009.01.20 22:59,buy,356,0.01,0.82518,,,AUDCAD
597,2009.01.20 22:59,buy,357,0.01,0.82520,,,AUDCAD
598,2009.01.20 22:59,buy,358,0.01,0.82512,,,AUDCAD
599,2009.01.20 22:59,buy,359,0.01,0.82504,,,AUDCAD
600,2009.01.20 22:59,buy,360,0.01,0.82496,,,AUDCAD
601,2009.01.20 22:59,buy,361,0.01,0.82488,,,AUDCAD
602,2009.01.20 22:59,buy,362,0.01,0.74634,,,AUDCHF
603,2009.01.20 22:59,buy,363,0.01,0.74625,,,AUDCHF
604,2009.01.20 22:59,buy,364,0.01,0.74616,,,AUDCHF
605,2009.01.20 22:59,buy,365,0.01,0.74618,,,AUDCHF
606,2009.01.20 22:59,buy,366,0.01,0.74620,,,AUDCHF
607,2009.01.20 22:59,buy,367,0.01,0.74611,,,AUDCHF
608,2009.01.20 22:59,buy,368,0.01,0.74602,,,AUDCHF
609,2009.01.20 22:59,buy,369,0.01,0.74605,,,AUDCHF
610,2009.01.20 22:59,buy,370,0.01,0.74607,,,AUDCHF
611,2009.01.20 22:59,buy,371,0.01,0.74596,,,AUDCHF
612,2009.01.20 22:59,buy,372,0.01,0.74584,,,AUDCHF
613,2009.01.20 23:00,buy,373,0.01,0.74594,,,AUDCHF
614,2009.01.20 23:00,buy,374,0.01,0.74599,,,AUDCHF
615,2009.01.20 23:00,buy,375,0.01,0.74597,,,AUDCHF
616,2009.01.20 23:00,buy,376,0.01,0.74595,,,AUDCHF
617,2009.01.20 23:00,buy,377,0.01,0.74604,,,AUDCHF
618,2009.01.20 23:00,buy,378,0.01,0.74595,,,AUDCHF
619,2009.01.20 23:00,buy,379,0.01,0.74586,,,AUDCHF
620,2009.01.20 23:00,buy,380,0.18,0.65088,,,AUDUSD
621,2009.01.20 23:00,buy,381,0.01,0.65073,,,AUDUSD
622,2009.01.20 23:02,buy,382,0.01,0.82297,,,AUDCAD
623,2009.01.20 23:02,buy,383,0.01,0.74472,,,AUDCHF
624,2009.01.20 23:02,buy,384,0.01,0.64976,,,AUDUSD
625,2009.01.20 23:17,sell,385,0.01,2.14027,,,GBPAUD
626,2009.01.20 23:22,buy,386,0.01,0.74464,,,AUDCHF
627,2009.01.20 23:22,buy,387,0.01,1.24246,,,AUDNZD
628,2009.01.20 23:22,buy,388,0.01,0.64843,,,AUDUSD
629,2009.01.20 23:22,sell,389,0.01,1.98550,,,EURAUD
630,2009.01.20 23:23,buy,390,0.01,0.82115,,,AUDCAD
631,2009.01.21 21:32,close,385,0.01,2.11722,23.87,12148.82,GBPAUD
632,2009.01.21 21:32,close,342,0.01,2.11722,21.01,12169.83,GBPAUD
633,2009.01.21 21:32,close,340,0.01,2.11722,23.18,12193.01,GBPAUD
634,2009.01.21 21:32,close,339,0.01,2.11722,23.10,12216.11,GBPAUD
635,2009.01.21 21:32,close,338,0.01,2.11722,23.04,12239.15,GBPAUD
636,2009.01.21 21:32,close,337,0.01,2.11722,22.97,12262.12,GBPAUD
637,2009.01.21 21:32,close,336,0.01,2.11722,23.00,12285.12,GBPAUD
638,2009.01.21 21:32,close,335,0.01,2.11722,23.04,12308.16,GBPAUD
639,2009.01.21 21:32,close,334,0.01,2.11722,23.07,12331.23,GBPAUD
640,2009.01.21 21:32,close,333,0.01,2.11722,22.90,12354.13,GBPAUD
641,2009.01.21 21:32,close,332,0.01,2.11722,22.73,12376.86,GBPAUD
642,2009.01.21 21:32,close,331,0.01,2.11722,22.56,12399.42,GBPAUD
643,2009.01.21 21:32,close,328,0.01,2.11722,22.76,12422.18,GBPAUD
644,2009.01.21 21:32,close,327,0.01,2.11722,22.63,12444.81,GBPAUD
645,2009.01.21 21:32,close,326,0.01,2.11722,22.56,12467.37,GBPAUD
646,2009.01.21 21:32,close,325,0.01,2.11722,22.71,12490.08,GBPAUD
647,2009.01.21 21:32,close,324,0.01,2.11722,22.86,12512.94,GBPAUD
648,2009.01.21 21:32,close,323,0.01,2.11722,22.81,12535.75,GBPAUD
649,2009.01.21 21:32,close,322,0.01,2.11722,22.97,12558.72,GBPAUD
650,2009.01.21 21:32,close,321,0.01,2.11722,22.76,12581.48,GBPAUD
651,2009.01.21 21:32,close,320,0.01,2.11722,21.74,12603.22,GBPAUD
652,2009.01.21 21:37,close,390,0.01,0.83157,10.37,12613.59,AUDCAD
653,2009.01.21 21:37,close,382,0.01,0.83157,8.56,12622.15,AUDCAD
654,2009.01.21 21:37,close,361,0.01,0.83157,6.67,12628.82,AUDCAD
655,2009.01.21 21:37,close,360,0.01,0.83157,6.59,12635.41,AUDCAD
656,2009.01.21 21:37,close,359,0.01,0.83157,6.51,12641.92,AUDCAD
657,2009.01.21 21:37,close,358,0.01,0.83157,6.43,12648.35,AUDCAD
658,2009.01.21 21:37,close,357,0.01,0.83157,6.35,12654.70,AUDCAD
659,2009.01.21 21:37,close,356,0.01,0.83157,6.37,12661.07,AUDCAD
660,2009.01.21 21:37,close,355,0.01,0.83157,6.38,12667.45,AUDCAD
661,2009.01.21 21:37,close,354,0.01,0.83157,6.40,12673.85,AUDCAD
662,2009.01.21 21:37,close,353,0.01,0.83157,6.41,12680.26,AUDCAD
663,2009.01.21 21:37,close,352,0.01,0.83157,6.43,12686.69,AUDCAD
664,2009.01.21 21:37,close,351,0.01,0.83157,6.35,12693.04,AUDCAD
665,2009.01.21 21:37,close,350,0.01,0.83157,6.26,12699.30,AUDCAD
666,2009.01.21 21:37,close,349,0.01,0.83157,6.18,12705.48,AUDCAD
667,2009.01.21 21:37,close,348,0.01,0.83157,6.10,12711.58,AUDCAD
668,2009.01.21 21:37,close,347,0.01,0.83157,6.13,12717.71,AUDCAD
669,2009.01.21 21:37,close,346,0.01,0.83157,6.16,12723.87,AUDCAD
670,2009.01.21 21:37,close,345,0.01,0.83157,6.20,12730.07,AUDCAD
671,2009.01.21 21:37,close,344,0.01,0.83157,6.23,12736.30,AUDCAD
672,2009.01.21 21:37,close,343,0.01,0.83157,6.26,12742.56,AUDCAD
673,2009.01.21 21:37,close,386,0.01,0.76284,19.52,12762.08,AUDCHF
674,2009.01.21 21:37,close,383,0.01,0.76284,19.44,12781.52,AUDCHF
675,2009.01.21 21:37,close,379,0.01,0.76284,18.22,12799.74,AUDCHF
676,2009.01.21 21:37,close,378,0.01,0.76284,18.12,12817.86,AUDCHF
677,2009.01.21 21:37,close,377,0.01,0.76284,18.02,12835.88,AUDCHF
678,2009.01.21 21:37,close,376,0.01,0.76284,18.12,12854.00,AUDCHF
679,2009.01.21 21:37,close,375,0.01,0.76284,18.10,12872.10,AUDCHF
680,2009.01.21 21:37,close,374,0.01,0.76284,18.08,12890.18,AUDCHF
681,2009.01.21 21:37,close,373,0.01,0.76284,18.13,12908.31,AUDCHF
682,2009.01.21 21:37,close,372,0.01,0.76284,18.24,12926.55,AUDCHF
683,2009.01.21 21:37,close,371,0.01,0.76284,18.11,12944.66,AUDCHF
684,2009.01.21 21:37,close,370,0.01,0.76284,17.99,12962.65,AUDCHF
685,2009.01.21 21:37,close,369,0.01,0.76284,18.01,12980.66,AUDCHF
686,2009.01.21 21:37,close,368,0.01,0.76284,18.05,12998.71,AUDCHF
687,2009.01.21 21:37,close,367,0.01,0.76284,17.95,13016.66,AUDCHF
688,2009.01.21 21:37,close,366,0.01,0.76284,17.85,13034.51,AUDCHF
689,2009.01.21 21:37,close,365,0.01,0.76284,17.87,13052.38,AUDCHF
690,2009.01.21 21:37,close,364,0.01,0.76284,17.90,13070.28,AUDCHF
691,2009.01.21 21:37,close,363,0.01,0.76284,17.80,13088.08,AUDCHF
692,2009.01.21 21:37,close,362,0.01,0.76284,17.70,13105.78,AUDCHF
693,2009.01.21 21:37,close,341,0.01,0.76284,17.81,13123.59,AUDCHF
694,2009.01.21 21:37,close,278,0.01,58.8250,2.25,13125.84,AUDJPY
695,2009.01.21 21:37,close,272,0.01,58.8250,0.61,13126.45,AUDJPY
696,2009.01.21 21:37,close,264,0.01,58.8250,-0.55,13125.90,AUDJPY
697,2009.01.21 21:37,close,255,0.01,58.8250,-1.69,13124.21,AUDJPY
698,2009.01.21 21:37,close,254,0.01,58.8250,-1.70,13122.51,AUDJPY
699,2009.01.21 21:37,close,243,0.01,58.8250,-6.63,13115.88,AUDJPY
700,2009.01.21 21:37,close,238,0.01,58.8250,-7.65,13108.23,AUDJPY
701,2009.01.21 21:37,close,226,0.01,58.8250,-8.51,13099.72,AUDJPY
702,2009.01.21 21:37,close,225,0.01,58.8250,-8.52,13091.20,AUDJPY
703,2009.01.21 21:37,close,224,0.01,58.8250,-8.45,13082.75,AUDJPY
704,2009.01.21 21:37,close,215,0.01,58.8250,-8.55,13074.20,AUDJPY
705,2009.01.21 21:37,close,202,0.01,58.8250,-18.35,13055.85,AUDJPY
706,2009.01.21 21:37,close,201,0.01,58.8250,-18.38,13037.47,AUDJPY
707,2009.01.21 21:37,close,190,0.01,58.8250,-21.39,13016.08,AUDJPY
708,2009.01.21 21:37,close,182,0.01,58.8250,-29.56,12986.52,AUDJPY
709,2009.01.21 21:37,close,172,0.01,58.8250,-30.95,12955.57,AUDJPY
710,2009.01.21 21:37,close,171,0.01,58.8250,-30.97,12924.60,AUDJPY
711,2009.01.21 21:37,close,170,0.01,58.8250,-30.99,12893.61,AUDJPY
712,2009.01.21 21:37,close,169,0.01,58.8250,-31.01,12862.60,AUDJPY
713,2009.01.21 21:37,close,144,0.01,58.8250,-36.92,12825.68,AUDJPY
714,2009.01.21 21:37,close,143,0.01,58.8250,-36.89,12788.79,AUDJPY
715,2009.01.21 21:37,close,142,0.01,58.8250,-36.97,12751.82,AUDJPY
716,2009.01.21 21:37,close,141,0.01,58.8250,-36.94,12714.88,AUDJPY
717,2009.01.21 21:37,close,123,0.01,58.8250,-56.29,12658.59,AUDJPY
718,2009.01.21 21:37,close,116,0.01,58.8250,-56.48,12602.11,AUDJPY
719,2009.01.21 21:37,close,111,0.01,58.8250,-57.24,12544.87,AUDJPY
720,2009.01.21 21:37,close,102,0.01,58.8250,-56.20,12488.67,AUDJPY
721,2009.01.21 21:37,close,96,0.01,58.8250,-55.03,12433.64,AUDJPY
722,2009.01.21 21:37,close,88,0.01,58.8250,-55.70,12377.94,AUDJPY
723,2009.01.21 21:37,close,87,0.01,58.8250,-55.63,12322.31,AUDJPY
724,2009.01.21 21:37,close,74,0.01,58.8250,-64.10,12258.21,AUDJPY
725,2009.01.21 21:37,close,67,0.01,58.8250,-65.31,12192.90,AUDJPY
726,2009.01.21 21:37,close,61,0.01,58.8250,-66.17,12126.73,AUDJPY
727,2009.01.21 21:37,close,50,0.01,58.8250,-66.47,12060.26,AUDJPY
728,2009.01.21 21:37,close,49,0.01,58.8250,-66.49,11993.77,AUDJPY
729,2009.01.21 21:37,close,41,0.01,58.8250,-71.05,11922.72,AUDJPY
730,2009.01.21 21:37,close,25,0.01,58.8250,-70.88,11851.84,AUDJPY
731,2009.01.21 21:37,close,24,0.01,58.8250,-70.85,11780.99,AUDJPY
732,2009.01.21 21:37,close,19,0.01,58.8250,-77.79,11703.20,AUDJPY
733,2009.01.21 21:37,close,11,0.01,58.8250,-78.35,11624.85,AUDJPY
734,2009.01.21 21:37,close,5,0.01,58.8250,-80.33,11544.52,AUDJPY
735,2009.01.21 21:37,close,387,0.01,1.24611,3.12,11547.64,AUDNZD
736,2009.01.21 21:37,close,329,0.01,1.24611,1.98,11549.62,AUDNZD
737,2009.01.21 21:37,close,300,0.01,1.24611,2.59,11552.21,AUDNZD
738,2009.01.21 21:37,close,299,0.01,1.24611,2.57,11554.78,AUDNZD
739,2009.01.21 21:37,close,298,0.01,1.24611,2.55,11557.33,AUDNZD
740,2009.01.21 21:37,close,297,0.01,1.24611,2.53,11559.86,AUDNZD
741,2009.01.21 21:37,close,296,0.01,1.24611,2.66,11562.52,AUDNZD
742,2009.01.21 21:37,close,295,0.01,1.24611,2.78,11565.30,AUDNZD
743,2009.01.21 21:37,close,294,0.01,1.24611,2.91,11568.21,AUDNZD
744,2009.01.21 21:37,close,293,0.01,1.24611,3.03,11571.24,AUDNZD
745,2009.01.21 21:37,close,292,0.01,1.24611,2.99,11574.23,AUDNZD
746,2009.01.21 21:37,close,291,0.01,1.24611,2.95,11577.18,AUDNZD
747,2009.01.21 21:37,close,290,0.01,1.24611,2.92,11580.10,AUDNZD
748,2009.01.21 21:37,close,289,0.01,1.24611,2.87,11582.97,AUDNZD
749,2009.01.21 21:37,close,288,0.01,1.24611,2.83,11585.80,AUDNZD
750,2009.01.21 21:37,close,287,0.01,1.24611,2.86,11588.66,AUDNZD
751,2009.01.21 21:37,close,286,0.01,1.24611,2.88,11591.54,AUDNZD
752,2009.01.21 21:37,close,285,0.01,1.24611,2.91,11594.45,AUDNZD
753,2009.01.21 21:37,close,284,0.01,1.24611,2.93,11597.38,AUDNZD
754,2009.01.21 21:37,close,283,0.01,1.24611,2.94,11600.32,AUDNZD
755,2009.01.21 21:37,close,282,0.01,1.24611,2.95,11603.27,AUDNZD
756,2009.01.21 21:37,close,388,0.01,0.65984,11.48,11614.75,AUDUSD
757,2009.01.21 21:37,close,384,0.01,0.65984,10.15,11624.90,AUDUSD
758,2009.01.21 21:37,close,381,0.01,0.65984,9.17,11634.07,AUDUSD
759,2009.01.21 21:37,close,380,0.18,0.65984,162.45,11796.52,AUDUSD
760,2009.01.21 21:37,close,389,0.01,1.96741,18.75,11815.27,EURAUD
761,2009.01.21 21:37,close,330,0.01,1.96741,16.83,11832.10,EURAUD
762,2009.01.21 21:37,close,319,0.01,1.96741,15.87,11847.97,EURAUD
763,2009.01.21 21:37,close,318,0.01,1.96741,16.12,11864.09,EURAUD
764,2009.01.21 21:37,close,317,0.01,1.96741,16.06,11880.15,EURAUD
765,2009.01.21 21:37,close,316,0.01,1.96741,16.00,11896.15,EURAUD
766,2009.01.21 21:37,close,315,0.01,1.96741,15.94,11912.09,EURAUD
767,2009.01.21 21:37,close,314,0.01,1.96741,15.88,11927.97,EURAUD
768,2009.01.21 21:37,close,313,0.01,1.96741,15.82,11943.79,EURAUD
769,2009.01.21 21:37,close,312,0.01,1.96741,16.06,11959.85,EURAUD
770,2009.01.21 21:37,close,311,0.01,1.96741,16.30,11976.15,EURAUD
771,2009.01.21 21:37,close,310,0.01,1.96741,16.54,11992.69,EURAUD
772,2009.01.21 21:37,close,309,0.01,1.96741,16.79,12009.48,EURAUD
773,2009.01.21 21:37,close,308,0.01,1.96741,17.03,12026.51,EURAUD
774,2009.01.21 21:37,close,307,0.01,1.96741,16.96,12043.47,EURAUD
775,2009.01.21 21:37,close,306,0.01,1.96741,16.90,12060.37,EURAUD
776,2009.01.21 21:37,close,305,0.01,1.96741,16.85,12077.22,EURAUD
777,2009.01.21 21:37,close,304,0.01,1.96741,16.79,12094.01,EURAUD
778,2009.01.21 21:37,close,303,0.01,1.96741,16.73,12110.74,EURAUD
779,2009.01.21 21:37,close,302,0.01,1.96741,16.92,12127.66,EURAUD
780,2009.01.21 21:37,close,301,0.01,1.96741,17.13,12144.79,EURAUD
781,2009.01.23 07:55,sell,391,0.01,2.11340,,,GBPAUD
782,2009.01.23 07:58,sell,392,0.01,1.98576,,,EURAUD
783,2009.01.23 07:59,buy,393,0.01,0.75344,,,AUDCHF
784,2009.01.23 07:59,buy,394,0.01,57.7010,,,AUDJPY
785,2009.01.23 07:59,buy,395,0.01,1.23216,,,AUDNZD
786,2009.01.23 08:00,buy,396,0.01,0.81795,,,AUDCAD
787,2009.01.23 08:00,buy,397,0.01,0.65128,,,AUDUSD
788,2009.01.23 08:23,sell,398,0.01,2.11398,,,GBPAUD
789,2009.01.23 08:27,sell,399,0.01,1.98886,,,EURAUD
790,2009.01.23 08:28,buy,400,0.01,0.81680,,,AUDCAD
791,2009.01.23 08:28,buy,401,0.01,0.75173,,,AUDCHF
792,2009.01.23 08:28,buy,402,0.01,57.5560,,,AUDJPY
793,2009.01.23 08:28,buy,403,0.01,1.23334,,,AUDNZD
794,2009.01.23 08:28,buy,404,0.01,0.64999,,,AUDUSD
795,2009.01.23 11:54,sell,405,0.01,2.10696,,,GBPAUD
796,2009.01.23 11:58,sell,406,0.01,1.99083,,,EURAUD
797,2009.01.23 11:59,buy,407,0.01,0.81325,,,AUDCAD
798,2009.01.23 11:59,buy,408,0.01,0.74990,,,AUDCHF
799,2009.01.23 11:59,buy,409,0.01,56.8270,,,AUDJPY
800,2009.01.23 11:59,buy,410,0.01,1.23899,,,AUDNZD
801,2009.01.23 11:59,buy,411,0.01,0.64398,,,AUDUSD
802,2009.01.23 17:25,close,405,0.01,2.09770,9.55,12154.34,GBPAUD
803,2009.01.23 17:25,close,398,0.01,2.09770,16.79,12171.13,GBPAUD
804,2009.01.23 17:25,close,391,0.01,2.09770,16.19,12187.32,GBPAUD
805,2009.01.23 17:30,close,407,0.01,0.81210,-1.14,12186.18,AUDCAD
806,2009.01.23 17:30,close,400,0.01,0.81210,-4.66,12181.52,AUDCAD
807,2009.01.23 17:30,close,396,0.01,0.81210,-5.80,12175.72,AUDCAD
808,2009.01.23 17:30,close,408,0.01,0.76160,12.51,12188.23,AUDCHF
809,2009.01.23 17:30,close,401,0.01,0.76160,10.55,12198.78,AUDCHF
810,2009.01.23 17:30,close,393,0.01,0.76160,8.72,12207.50,AUDCHF
811,2009.01.23 17:30,close,409,0.01,58.3000,14.85,12222.35,AUDJPY
812,2009.01.23 17:30,close,402,0.01,58.3000,7.50,12229.85,AUDJPY
813,2009.01.23 17:30,close,394,0.01,58.3000,6.04,12235.89,AUDJPY
814,2009.01.23 17:30,close,410,0.01,1.23240,-5.63,12230.26,AUDNZD
815,2009.01.23 17:30,close,403,0.01,1.23240,-0.80,12229.46,AUDNZD
816,2009.01.23 17:30,close,395,0.01,1.23240,0.20,12229.66,AUDNZD
817,2009.01.23 17:30,close,411,0.01,0.65290,8.92,12238.58,AUDUSD
818,2009.01.23 17:30,close,404,0.01,0.65290,2.91,12241.49,AUDUSD
819,2009.01.23 17:30,close,397,0.01,0.65290,1.62,12243.11,AUDUSD
820,2009.01.23 17:30,close,406,0.01,1.96474,26.90,12270.01,EURAUD
821,2009.01.23 17:30,close,399,0.01,1.96474,24.87,12294.88,EURAUD
822,2009.01.23 17:30,close,392,0.01,1.96474,21.68,12316.56,EURAUD
823,2009.01.29 10:55,sell,412,0.01,2.15000,,,GBPAUD
824,2009.01.29 10:59,sell,413,0.01,1.98777,,,EURAUD
825,2009.01.29 11:00,buy,414,0.01,0.80175,,,AUDCAD
826,2009.01.29 11:00,buy,415,0.01,0.75894,,,AUDCHF
827,2009.01.29 11:00,buy,416,0.01,59.0810,,,AUDJPY
828,2009.01.29 11:00,buy,417,0.01,1.27556,,,AUDNZD
829,2009.01.29 11:00,buy,418,0.01,0.65598,,,AUDUSD
830,2009.01.29 11:07,sell,419,0.01,2.15130,,,GBPAUD
831,2009.01.29 11:09,sell,420,0.01,2.15825,,,GBPAUD
832,2009.01.29 11:11,sell,421,0.01,1.99080,,,EURAUD
833,2009.01.29 11:12,buy,422,0.01,59.0850,,,AUDJPY
834,2009.01.29 11:12,buy,423,0.01,1.27576,,,AUDNZD
835,2009.01.29 11:12,buy,424,0.01,0.65603,,,AUDUSD
836,2009.01.29 11:13,buy,425,0.01,0.79995,,,AUDCAD
837,2009.01.29 11:13,buy,426,0.01,0.75664,,,AUDCHF
838,2009.01.29 11:13,sell,427,0.01,1.99210,,,EURAUD
839,2009.01.29 11:14,buy,428,0.01,0.80005,,,AUDCAD
840,2009.01.29 11:14,buy,429,0.01,0.75673,,,AUDCHF
841,2009.01.29 11:14,buy,430,0.01,59.0630,,,AUDJPY
842,2009.01.29 11:14,buy,431,0.01,1.27475,,,AUDNZD
843,2009.01.29 11:14,buy,432,0.01,0.65558,,,AUDUSD
844,2009.01.29 12:33,sell,433,0.01,2.16873,,,GBPAUD
845,2009.01.29 12:37,sell,434,0.01,1.98960,,,EURAUD
846,2009.01.29 12:38,buy,435,0.01,0.80015,,,AUDCAD
847,2009.01.29 12:38,buy,436,0.01,0.75784,,,AUDCHF
848,2009.01.29 12:38,buy,437,0.01,59.1090,,,AUDJPY
849,2009.01.29 12:38,buy,438,0.01,1.26842,,,AUDNZD
850,2009.01.29 12:38,buy,439,0.01,0.65883,,,AUDUSD
851,2009.01.29 14:27,sell,440,0.01,1.99319,,,EURAUD
852,2009.01.29 14:29,sell,441,0.01,2.17254,,,GBPAUD
853,2009.01.29 14:30,buy,442,0.01,0.80105,,,AUDCAD
854,2009.01.29 14:30,buy,443,0.01,0.75602,,,AUDCHF
855,2009.01.29 14:30,buy,444,0.01,59.1960,,,AUDJPY
856,2009.01.29 14:30,buy,445,0.01,1.26723,,,AUDNZD
857,2009.01.29 14:32,buy,446,0.01,0.65798,,,AUDUSD
858,2009.01.29 19:31,sell,447,0.01,2.18110,,,GBPAUD
859,2009.01.29 19:32,sell,448,0.01,1.98080,,,EURAUD
860,2009.01.29 19:36,buy,449,0.01,0.79785,,,AUDCAD
861,2009.01.29 19:36,buy,450,0.01,0.75304,,,AUDCHF
862,2009.01.29 19:36,buy,451,0.01,58.7310,,,AUDJPY
863,2009.01.29 19:36,buy,452,0.01,1.26856,,,AUDNZD
864,2009.01.29 19:36,buy,453,0.01,0.65453,,,AUDUSD
865,2009.01.29 22:25,sell,454,0.01,2.19060,,,GBPAUD
866,2009.01.29 22:26,buy,455,0.01,1.27114,,,AUDNZD
867,2009.01.29 22:27,sell,456,0.01,1.98433,,,EURAUD
868,2009.01.29 22:30,buy,457,0.01,0.79835,,,AUDCAD
869,2009.01.29 22:30,buy,458,0.01,0.75224,,,AUDCHF
870,2009.01.29 22:30,buy,459,0.01,58.6810,,,AUDJPY
871,2009.01.29 22:30,buy,460,0.01,0.65208,,,AUDUSD
872,2009.01.29 22:34,sell,461,0.01,2.19055,,,GBPAUD
873,2009.01.29 22:35,buy,462,0.01,1.26806,,,AUDNZD
874,2009.01.29 22:39,buy,463,0.01,0.79785,,,AUDCAD
875,2009.01.29 22:39,buy,464,0.01,0.75209,,,AUDCHF
876,2009.01.29 22:39,buy,465,0.01,58.6250,,,AUDJPY
877,2009.01.29 22:39,buy,466,0.01,0.65188,,,AUDUSD
878,2009.01.29 22:39,sell,467,0.01,1.98580,,,EURAUD
879,2009.01.30 07:25,sell,468,0.01,2.20380,,,GBPAUD
880,2009.01.30 07:25,sell,469,0.01,2.20362,,,GBPAUD
881,2009.01.30 07:25,sell,470,0.01,2.20344,,,GBPAUD
882,2009.01.30 07:28,sell,471,0.01,1.99152,,,EURAUD
883,2009.01.30 07:28,sell,472,0.01,1.99155,,,EURAUD
884,2009.01.30 07:28,sell,473,0.01,1.99149,,,EURAUD
885,2009.01.30 07:29,buy,474,0.01,0.79403,,,AUDCAD
886,2009.01.30 07:29,buy,475,0.01,0.79401,,,AUDCAD
887,2009.01.30 07:29,buy,476,0.01,0.79400,,,AUDCAD
888,2009.01.30 07:29,buy,477,0.01,0.74664,,,AUDCHF
889,2009.01.30 07:29,buy,478,0.01,0.74662,,,AUDCHF
890,2009.01.30 07:29,buy,479,0.01,0.74659,,,AUDCHF
891,2009.01.30 07:29,buy,480,0.01,57.8860,,,AUDJPY
892,2009.01.30 07:29,buy,481,0.01,57.8850,,,AUDJPY
893,2009.01.30 07:29,buy,482,0.01,57.8840,,,AUDJPY
894,2009.01.30 07:29,buy,483,0.01,1.26269,,,AUDNZD
895,2009.01.30 07:29,buy,484,0.01,1.26253,,,AUDNZD
896,2009.01.30 07:29,buy,485,0.01,1.26236,,,AUDNZD
897,2009.01.30 07:30,buy,486,0.02,0.64768,,,AUDUSD
898,2009.01.30 07:30,buy,487,0.01,0.64778,,,AUDUSD
899,2009.01.30 07:49,sell,488,0.01,2.20117,,,GBPAUD
900,2009.01.30 07:51,sell,489,0.01,1.99425,,,EURAUD
901,2009.01.30 07:54,buy,490,0.01,0.74639,,,AUDCHF
902,2009.01.30 07:54,buy,491,0.01,0.64718,,,AUDUSD
903,2009.01.30 07:55,buy,492,0.01,0.79345,,,AUDCAD
904,2009.01.30 07:55,buy,493,0.01,57.9010,,,AUDJPY
905,2009.01.30 07:55,buy,494,0.01,1.26296,,,AUDNZD
906,2009.01.30 17:55,sell,495,0.01,2.26060,,,GBPAUD
907,2009.01.30 17:55,sell,496,0.01,2.26058,,,GBPAUD
908,2009.01.30 17:55,sell,497,0.01,2.26056,,,GBPAUD
909,2009.01.30 17:55,sell,498,0.01,2.26054,,,GBPAUD
910,2009.01.30 17:55,sell,499,0.01,2.26052,,,GBPAUD
911,2009.01.30 17:55,sell,500,0.01,2.26050,,,GBPAUD
912,2009.01.30 17:55,sell,501,0.01,2.26048,,,GBPAUD
913,2009.01.30 17:55,sell,502,0.01,2.26046,,,GBPAUD
914,2009.01.30 17:57,sell,503,0.01,2.25925,,,GBPAUD
915,2009.01.30 17:59,buy,504,0.01,0.78840,,,AUDCAD
916,2009.01.30 17:59,buy,505,0.01,0.78835,,,AUDCAD
917,2009.01.30 17:59,buy,506,0.01,0.74064,,,AUDCHF
918,2009.01.30 17:59,buy,507,0.01,1.25521,,,AUDNZD
919,2009.01.30 17:59,buy,508,0.01,1.25524,,,AUDNZD
920,2009.01.30 17:59,buy,509,0.01,1.25528,,,AUDNZD
921,2009.01.30 17:59,buy,510,0.01,1.25514,,,AUDNZD
922,2009.01.30 17:59,buy,511,0.01,1.25501,,,AUDNZD
923,2009.01.30 17:59,buy,512,0.01,1.25487,,,AUDNZD
924,2009.01.30 17:59,buy,513,0.01,1.25416,,,AUDNZD
925,2009.01.30 17:59,sell,514,0.01,2.00738,,,EURAUD
926,2009.01.30 17:59,sell,515,0.01,2.00750,,,EURAUD
927,2009.01.30 18:00,buy,516,0.01,0.78845,,,AUDCAD
928,2009.01.30 18:00,buy,517,0.01,0.78837,,,AUDCAD
929,2009.01.30 18:00,buy,518,0.01,0.78829,,,AUDCAD
930,2009.01.30 18:00,buy,519,0.01,0.78820,,,AUDCAD
931,2009.01.30 18:00,buy,520,0.01,0.78812,,,AUDCAD
932,2009.01.30 18:00,buy,521,0.01,0.78814,,,AUDCAD
933,2009.01.30 18:00,buy,522,0.01,0.74054,,,AUDCHF
934,2009.01.30 18:00,buy,523,0.01,0.74047,,,AUDCHF
935,2009.01.30 18:00,buy,524,0.01,0.74039,,,AUDCHF
936,2009.01.30 18:00,buy,525,0.01,0.74040,,,AUDCHF
937,2009.01.30 18:00,buy,526,0.01,0.74042,,,AUDCHF
938,2009.01.30 18:00,buy,527,0.01,0.74043,,,AUDCHF
939,2009.01.30 18:00,buy,528,0.01,0.74039,,,AUDCHF
940,2009.01.30 18:00,buy,529,0.01,57.2810,,,AUDJPY
941,2009.01.30 18:00,buy,530,0.01,57.2740,,,AUDJPY
942,2009.01.30 18:00,buy,531,0.01,57.2660,,,AUDJPY
943,2009.01.30 18:00,buy,532,0.01,57.2670,,,AUDJPY
944,2009.01.30 18:00,buy,533,0.01,57.2690,,,AUDJPY
945,2009.01.30 18:00,buy,534,0.01,57.2700,,,AUDJPY
946,2009.01.30 18:00,buy,535,0.01,57.2650,,,AUDJPY
947,2009.01.30 18:00,buy,536,0.01,57.2610,,,AUDJPY
948,2009.01.30 18:00,buy,537,0.01,1.25426,,,AUDNZD
949,2009.01.30 18:00,buy,538,0.07,0.63768,,,AUDUSD
950,2009.01.30 18:00,buy,539,0.01,0.63773,,,AUDUSD
951,2009.01.30 18:00,sell,540,0.01,2.00730,,,EURAUD
952,2009.01.30 18:00,sell,541,0.01,2.00721,,,EURAUD
953,2009.01.30 18:00,sell,542,0.01,2.00712,,,EURAUD
954,2009.01.30 18:00,sell,543,0.01,2.00704,,,EURAUD
955,2009.01.30 18:00,sell,544,0.01,2.00695,,,EURAUD
956,2009.01.30 18:00,sell,545,0.01,2.00686,,,EURAUD
957,2009.01.30 18:00,sell,546,0.01,2.26173,,,GBPAUD
958,2009.01.30 18:02,buy,547,0.01,0.78723,,,AUDCAD
959,2009.01.30 18:02,buy,548,0.01,0.73936,,,AUDCHF
960,2009.01.30 18:02,buy,549,0.01,57.1760,,,AUDJPY
961,2009.01.30 18:02,buy,550,0.01,1.25266,,,AUDNZD
962,2009.01.30 18:02,buy,551,0.01,0.63683,,,AUDUSD
963,2009.01.30 18:02,sell,552,0.01,2.00857,,,EURAUD
964,2009.01.30 18:05,buy,553,0.01,0.78593,,,AUDCAD
965,2009.01.30 18:05,buy,554,0.01,0.73842,,,AUDCHF
966,2009.01.30 18:05,buy,555,0.01,57.0360,,,AUDJPY
967,2009.01.30 18:05,buy,556,0.01,1.25279,,,AUDNZD
968,2009.01.30 18:05,buy,557,0.01,0.63553,,,AUDUSD
969,2009.01.30 18:05,sell,558,0.01,2.01136,,,EURAUD
970,2009.01.30 20:31,sell,559,0.01,2.00978,,,EURAUD
971,2009.01.30 20:36,buy,560,0.01,0.78179,,,AUDCAD
972,2009.01.30 20:36,buy,561,0.01,0.73905,,,AUDCHF
973,2009.01.30 20:36,buy,562,0.01,57.2220,,,AUDJPY
974,2009.01.30 20:36,buy,563,0.01,1.25244,,,AUDNZD
975,2009.01.30 20:36,buy,564,0.01,0.63617,,,AUDUSD
976,2009.01.30 20:36,sell,565,0.01,2.27145,,,GBPAUD
977,2009.02.02 00:00,buy,566,0.01,0.78045,,,AUDCAD
978,2009.02.02 00:00,buy,567,0.01,0.74024,,,AUDCHF
979,2009.02.02 00:00,buy,568,0.01,57.0310,,,AUDJPY
980,2009.02.02 00:00,buy,569,0.01,1.25066,,,AUDNZD
981,2009.02.02 00:00,buy,570,0.01,0.63608,,,AUDUSD
982,2009.02.02 00:00,sell,571,0.01,2.00430,,,EURAUD
983,2009.02.02 00:00,sell,572,0.01,2.26910,,,GBPAUD
984,2009.02.02 02:57,sell,573,0.01,2.27370,,,GBPAUD
985,2009.02.02 02:58,sell,574,0.01,2.01252,,,EURAUD
986,2009.02.02 03:02,buy,575,0.01,0.77885,,,AUDCAD
987,2009.02.02 03:02,buy,576,0.01,0.73748,,,AUDCHF
988,2009.02.02 03:02,buy,577,0.01,56.8010,,,AUDJPY
989,2009.02.02 03:02,buy,578,0.01,1.24985,,,AUDNZD
990,2009.02.02 03:02,buy,579,0.01,0.63218,,,AUDUSD
991,2009.02.02 11:55,sell,580,0.01,2.26760,,,GBPAUD
992,2009.02.02 11:55,sell,581,0.01,2.26756,,,GBPAUD
993,2009.02.02 11:59,buy,582,0.01,0.77648,,,AUDCAD
994,2009.02.02 11:59,buy,583,0.01,0.77655,,,AUDCAD
995,2009.02.02 11:59,buy,584,0.01,55.7810,,,AUDJPY
996,2009.02.02 12:00,buy,585,0.01,0.73214,,,AUDCHF
997,2009.02.02 12:00,buy,586,0.01,0.73216,,,AUDCHF
998,2009.02.02 12:00,buy,587,0.01,55.7710,,,AUDJPY
999,2009.02.02 12:00,buy,588,0.01,1.25616,,,AUDNZD
1000,2009.02.02 12:00,buy,589,0.01,1.25609,,,AUDNZD
1001,2009.02.02 12:00,buy,590,0.01,0.62738,,,AUDUSD
1002,2009.02.02 12:00,buy,591,0.01,0.62734,,,AUDUSD
1003,2009.02.02 12:00,sell,592,0.01,2.02800,,,EURAUD
1004,2009.02.02 12:00,sell,593,0.01,2.02808,,,EURAUD
1005,2009.02.02 12:00,sell,594,0.01,2.26844,,,GBPAUD
1006,2009.02.02 12:04,sell,595,0.01,2.02910,,,EURAUD
1007,2009.02.02 12:05,buy,596,0.01,0.77664,,,AUDCAD
1008,2009.02.02 12:05,buy,597,0.01,0.73185,,,AUDCHF
1009,2009.02.02 12:05,buy,598,0.01,55.8080,,,AUDJPY
1010,2009.02.02 12:05,buy,599,0.01,1.25552,,,AUDNZD
1011,2009.02.02 12:05,buy,600,0.01,0.62716,,,AUDUSD
1012,2009.02.03 04:44,close,594,0.01,2.21957,50.49,12367.05,GBPAUD
1013,2009.02.03 04:44,close,581,0.01,2.21957,49.58,12416.63,GBPAUD
1014,2009.02.03 04:44,close,580,0.01,2.21957,49.62,12466.25,GBPAUD
1015,2009.02.03 04:44,close,573,0.01,2.21957,55.91,12522.16,GBPAUD
1016,2009.02.03 04:44,close,572,0.01,2.21957,51.17,12573.33,GBPAUD
1017,2009.02.03 04:44,close,565,0.01,2.21957,53.69,12627.02,GBPAUD
1018,2009.02.03 04:44,close,546,0.01,2.21957,43.67,12670.69,GBPAUD
1019,2009.02.03 04:44,close,503,0.01,2.21957,41.11,12711.80,GBPAUD
1020,2009.02.03 04:44,close,502,0.01,2.21957,42.36,12754.16,GBPAUD
1021,2009.02.03 04:44,close,501,0.01,2.21957,42.38,12796.54,GBPAUD
1022,2009.02.03 04:44,close,500,0.01,2.21957,42.40,12838.94,GBPAUD
1023,2009.02.03 04:44,close,499,0.01,2.21957,42.42,12881.36,GBPAUD
1024,2009.02.03 04:44,close,498,0.01,2.21957,42.44,12923.80,GBPAUD
1025,2009.02.03 04:44,close,497,0.01,2.21957,42.46,12966.26,GBPAUD
1026,2009.02.03 04:44,close,496,0.01,2.21957,42.48,13008.74,GBPAUD
1027,2009.02.03 04:44,close,495,0.01,2.21957,42.50,13051.24,GBPAUD
1028,2009.02.03 04:44,close,488,0.01,2.21957,-18.78,13032.46,GBPAUD
1029,2009.02.03 04:44,close,470,0.01,2.21957,-16.44,13016.02,GBPAUD
1030,2009.02.03 04:44,close,469,0.01,2.21957,-16.25,12999.77,GBPAUD
1031,2009.02.03 04:44,close,468,0.01,2.21957,-16.07,12983.70,GBPAUD
1032,2009.02.03 04:44,close,461,0.01,2.21957,-29.63,12954.07,GBPAUD
1033,2009.02.03 04:44,close,454,0.01,2.21957,-29.58,12924.49,GBPAUD
1034,2009.02.03 04:44,close,447,0.01,2.21957,-39.37,12885.12,GBPAUD
1035,2009.02.03 04:44,close,441,0.01,2.21957,-48.20,12836.92,GBPAUD
1036,2009.02.03 04:44,close,433,0.01,2.21957,-52.13,12784.79,GBPAUD
1037,2009.02.03 04:44,close,420,0.01,2.21957,-62.93,12721.86,GBPAUD
1038,2009.02.03 04:44,close,419,0.01,2.21957,-70.10,12651.76,GBPAUD
1039,2009.02.03 04:44,close,412,0.01,2.21957,-71.44,12580.32,GBPAUD
1040,2009.02.03 04:45,close,595,0.01,2.01085,18.92,12599.24,EURAUD
1041,2009.02.03 04:45,close,593,0.01,2.01085,17.86,12617.10,EURAUD
1042,2009.02.03 04:45,close,592,0.01,2.01085,17.78,12634.88,EURAUD
1043,2009.02.03 04:45,close,574,0.01,2.01085,1.82,12636.70,EURAUD
1044,2009.02.03 04:45,close,571,0.01,2.01085,-6.66,12630.04,EURAUD
1045,2009.02.03 04:45,close,559,0.01,2.01085,-0.91,12629.13,EURAUD
1046,2009.02.03 04:45,close,558,0.01,2.01085,0.72,12629.85,EURAUD
1047,2009.02.03 04:45,close,552,0.01,2.01085,-2.15,12627.70,EURAUD
1048,2009.02.03 04:45,close,545,0.01,2.01085,-3.92,12623.78,EURAUD
1049,2009.02.03 04:45,close,544,0.01,2.01085,-3.82,12619.96,EURAUD
1050,2009.02.03 04:45,close,543,0.01,2.01085,-3.73,12616.23,EURAUD
1051,2009.02.03 04:45,close,542,0.01,2.01085,-3.65,12612.58,EURAUD
1052,2009.02.03 04:45,close,541,0.01,2.01085,-3.56,12609.02,EURAUD
1053,2009.02.03 04:45,close,540,0.01,2.01085,-3.46,12605.56,EURAUD
1054,2009.02.03 04:45,close,515,0.01,2.01085,-3.26,12602.30,EURAUD
1055,2009.02.03 04:45,close,514,0.01,2.01085,-3.38,12598.92,EURAUD
1056,2009.02.03 04:45,close,489,0.01,2.01085,-16.92,12582.00,EURAUD
1057,2009.02.03 04:45,close,473,0.01,2.01085,-19.76,12562.24,EURAUD
1058,2009.02.03 04:45,close,472,0.01,2.01085,-19.70,12542.54,EURAUD
1059,2009.02.03 04:45,close,471,0.01,2.01085,-19.73,12522.81,EURAUD
1060,2009.02.03 04:45,close,467,0.01,2.01085,-25.54,12497.27,EURAUD
1061,2009.02.03 04:45,close,456,0.01,2.01085,-27.06,12470.21,EURAUD
1062,2009.02.03 04:45,close,448,0.01,2.01085,-30.70,12439.51,EURAUD
1063,2009.02.03 04:45,close,440,0.01,2.01085,-17.92,12421.59,EURAUD
1064,2009.02.03 04:45,close,434,0.01,2.01085,-21.62,12399.97,EURAUD
1065,2009.02.03 04:45,close,427,0.01,2.01085,-19.05,12380.92,EURAUD
1066,2009.02.03 04:45,close,421,0.01,2.01085,-20.39,12360.53,EURAUD
1067,2009.02.03 04:45,close,413,0.01,2.01085,-23.51,12337.02,EURAUD
1068,2009.02.03 04:49,close,596,0.01,0.79602,19.26,12356.28,AUDCAD
1069,2009.02.03 04:49,close,583,0.01,0.79602,19.35,12375.63,AUDCAD
1070,2009.02.03 04:49,close,582,0.01,0.79602,19.42,12395.05,AUDCAD
1071,2009.02.03 04:49,close,575,0.01,0.79602,17.07,12412.12,AUDCAD
1072,2009.02.03 04:49,close,566,0.01,0.79602,15.48,12427.60,AUDCAD
1073,2009.02.03 04:49,close,560,0.01,0.79602,14.20,12441.80,AUDCAD
1074,2009.02.03 04:49,close,553,0.01,0.79602,10.10,12451.90,AUDCAD
1075,2009.02.03 04:49,close,547,0.01,0.79602,8.81,12460.71,AUDCAD
1076,2009.02.03 04:49,close,521,0.01,0.79602,7.91,12468.62,AUDCAD
1077,2009.02.03 04:49,close,520,0.01,0.79602,7.93,12476.55,AUDCAD
1078,2009.02.03 04:49,close,519,0.01,0.79602,7.85,12484.40,AUDCAD
1079,2009.02.03 04:49,close,518,0.01,0.79602,7.76,12492.16,AUDCAD
1080,2009.02.03 04:49,close,517,0.01,0.79602,7.68,12499.84,AUDCAD
1081,2009.02.03 04:49,close,516,0.01,0.79602,7.60,12507.44,AUDCAD
1082,2009.02.03 04:49,close,505,0.01,0.79602,7.70,12515.14,AUDCAD
1083,2009.02.03 04:49,close,504,0.01,0.79602,7.65,12522.79,AUDCAD
1084,2009.02.03 04:49,close,492,0.01,0.79602,2.64,12525.43,AUDCAD
1085,2009.02.03 04:49,close,476,0.01,0.79602,2.10,12527.53,AUDCAD
1086,2009.02.03 04:49,close,475,0.01,0.79602,2.09,12529.62,AUDCAD
1087,2009.02.03 04:49,close,474,0.01,0.79602,2.07,12531.69,AUDCAD
1088,2009.02.03 04:49,close,463,0.01,0.79602,-1.68,12530.01,AUDCAD
1089,2009.02.03 04:49,close,457,0.01,0.79602,-2.18,12527.83,AUDCAD
1090,2009.02.03 04:49,close,449,0.01,0.79602,-1.68,12526.15,AUDCAD
1091,2009.02.03 04:49,close,442,0.01,0.79602,-4.85,12521.30,AUDCAD
1092,2009.02.03 04:49,close,435,0.01,0.79602,-3.96,12517.34,AUDCAD
1093,2009.02.03 04:49,close,428,0.01,0.79602,-3.86,12513.48,AUDCAD
1094,2009.02.03 04:49,close,425,0.01,0.79602,-3.76,12509.72,AUDCAD
1095,2009.02.03 04:49,close,414,0.01,0.79602,-5.55,12504.17,AUDCAD
1096,2009.02.03 04:49,close,597,0.01,0.74388,12.92,12517.09,AUDCHF
1097,2009.02.03 04:49,close,586,0.01,0.74388,12.59,12529.68,AUDCHF
1098,2009.02.03 04:49,close,585,0.01,0.74388,12.61,12542.29,AUDCHF
1099,2009.02.03 04:49,close,576,0.01,0.74388,6.91,12549.20,AUDCHF
1100,2009.02.03 04:49,close,567,0.01,0.74388,3.95,12553.15,AUDCHF
1101,2009.02.03 04:49,close,561,0.01,0.74388,5.30,12558.45,AUDCHF
1102,2009.02.03 04:49,close,554,0.01,0.74388,5.97,12564.42,AUDCHF
1103,2009.02.03 04:49,close,548,0.01,0.74388,4.97,12569.39,AUDCHF
1104,2009.02.03 04:49,close,528,0.01,0.74388,3.86,12573.25,AUDCHF
1105,2009.02.03 04:49,close,527,0.01,0.74388,3.82,12577.07,AUDCHF
1106,2009.02.03 04:49,close,526,0.01,0.74388,3.83,12580.90,AUDCHF
1107,2009.02.03 04:49,close,525,0.01,0.74388,3.85,12584.75,AUDCHF
1108,2009.02.03 04:49,close,524,0.01,0.74388,3.86,12588.61,AUDCHF
1109,2009.02.03 04:49,close,523,0.01,0.74388,3.78,12592.39,AUDCHF
1110,2009.02.03 04:49,close,522,0.01,0.74388,3.70,12596.09,AUDCHF
1111,2009.02.03 04:49,close,506,0.01,0.74388,3.60,12599.69,AUDCHF
1112,2009.02.03 04:49,close,490,0.01,0.74388,-2.55,12597.14,AUDCHF
1113,2009.02.03 04:49,close,479,0.01,0.74388,-2.76,12594.38,AUDCHF
1114,2009.02.03 04:49,close,478,0.01,0.74388,-2.80,12591.58,AUDCHF
1115,2009.02.03 04:49,close,477,0.01,0.74388,-2.82,12588.76,AUDCHF
1116,2009.02.03 04:49,close,464,0.01,0.74388,-8.58,12580.18,AUDCHF
1117,2009.02.03 04:49,close,458,0.01,0.74388,-8.74,12571.44,AUDCHF
1118,2009.02.03 04:49,close,450,0.01,0.74388,-9.60,12561.84,AUDCHF
1119,2009.02.03 04:49,close,443,0.01,0.74388,-12.78,12549.06,AUDCHF
1120,2009.02.03 04:49,close,436,0.01,0.74388,-14.73,12534.33,AUDCHF
1121,2009.02.03 04:49,close,429,0.01,0.74388,-13.54,12520.79,AUDCHF
1122,2009.02.03 04:49,close,426,0.01,0.74388,-13.45,12507.34,AUDCHF
1123,2009.02.03 04:49,close,415,0.01,0.74388,-15.91,12491.43,AUDCHF
1124,2009.02.03 04:49,close,598,0.01,57.6010,18.15,12509.58,AUDJPY
1125,2009.02.03 04:49,close,587,0.01,57.6010,18.53,12528.11,AUDJPY
1126,2009.02.03 04:49,close,584,0.01,57.6010,18.43,12546.54,AUDJPY
1127,2009.02.03 04:49,close,577,0.01,57.6010,8.14,12554.68,AUDJPY
1128,2009.02.03 04:49,close,568,0.01,57.6010,5.82,12560.50,AUDJPY
1129,2009.02.03 04:49,close,562,0.01,57.6010,3.98,12564.48,AUDJPY
1130,2009.02.03 04:49,close,555,0.01,57.6010,5.85,12570.33,AUDJPY
1131,2009.02.03 04:49,close,549,0.01,57.6010,4.44,12574.77,AUDJPY
1132,2009.02.03 04:49,close,536,0.01,57.6010,3.58,12578.35,AUDJPY
1133,2009.02.03 04:49,close,535,0.01,57.6010,3.54,12581.89,AUDJPY
1134,2009.02.03 04:49,close,534,0.01,57.6010,3.49,12585.38,AUDJPY
1135,2009.02.03 04:49,close,533,0.01,57.6010,3.50,12588.88,AUDJPY
1136,2009.02.03 04:49,close,532,0.01,57.6010,3.52,12592.40,AUDJPY
1137,2009.02.03 04:49,close,531,0.01,57.6010,3.53,12595.93,AUDJPY
1138,2009.02.03 04:49,close,530,0.01,57.6010,3.45,12599.38,AUDJPY
1139,2009.02.03 04:49,close,529,0.01,57.6010,3.38,12602.76,AUDJPY
1140,2009.02.03 04:49,close,493,0.01,57.6010,-2.87,12599.89,AUDJPY
1141,2009.02.03 04:49,close,482,0.01,57.6010,-2.70,12597.19,AUDJPY
1142,2009.02.03 04:49,close,481,0.01,57.6010,-2.71,12594.48,AUDJPY
1143,2009.02.03 04:49,close,480,0.01,57.6010,-2.72,12591.76,AUDJPY
1144,2009.02.03 04:49,close,465,0.01,57.6010,-10.10,12581.66,AUDJPY
1145,2009.02.03 04:49,close,459,0.01,57.6010,-10.67,12570.99,AUDJPY
1146,2009.02.03 04:49,close,451,0.01,57.6010,-11.17,12559.82,AUDJPY
1147,2009.02.03 04:49,close,444,0.01,57.6010,-15.86,12543.96,AUDJPY
1148,2009.02.03 04:49,close,437,0.01,57.6010,-14.98,12528.98,AUDJPY
1149,2009.02.03 04:49,close,430,0.01,57.6010,-14.52,12514.46,AUDJPY
1150,2009.02.03 04:49,close,422,0.01,57.6010,-14.74,12499.72,AUDJPY
1151,2009.02.03 04:49,close,416,0.01,57.6010,-14.70,12485.02,AUDJPY
1152,2009.02.03 04:49,close,599,0.01,1.25477,-0.64,12484.38,AUDNZD
1153,2009.02.03 04:49,close,589,0.01,1.25477,-1.13,12483.25,AUDNZD
1154,2009.02.03 04:49,close,588,0.01,1.25477,-1.19,12482.06,AUDNZD
1155,2009.02.03 04:49,close,578,0.01,1.25477,4.20,12486.26,AUDNZD
1156,2009.02.03 04:49,close,569,0.01,1.25477,3.51,12489.77,AUDNZD
1157,2009.02.03 04:49,close,563,0.01,1.25477,1.98,12491.75,AUDNZD
1158,2009.02.03 04:49,close,556,0.01,1.25477,1.68,12493.43,AUDNZD
1159,2009.02.03 04:49,close,550,0.01,1.25477,1.79,12495.22,AUDNZD
1160,2009.02.03 04:49,close,537,0.01,1.25477,0.43,12495.65,AUDNZD
1161,2009.02.03 04:49,close,513,0.01,1.25477,0.51,12496.16,AUDNZD
1162,2009.02.03 04:49,close,512,0.01,1.25477,-0.10,12496.06,AUDNZD
1163,2009.02.03 04:49,close,511,0.01,1.25477,-0.21,12495.85,AUDNZD
1164,2009.02.03 04:49,close,510,0.01,1.25477,-0.33,12495.52,AUDNZD
1165,2009.02.03 04:49,close,509,0.01,1.25477,-0.45,12495.07,AUDNZD
1166,2009.02.03 04:49,close,508,0.01,1.25477,-0.41,12494.66,AUDNZD
1167,2009.02.03 04:49,close,507,0.01,1.25477,-0.39,12494.27,AUDNZD
1168,2009.02.03 04:49,close,494,0.01,1.25477,-7.00,12487.27,AUDNZD
1169,2009.02.03 04:49,close,485,0.01,1.25477,-6.49,12480.78,AUDNZD
1170,2009.02.03 04:49,close,484,0.01,1.25477,-6.64,12474.14,AUDNZD
1171,2009.02.03 04:49,close,483,0.01,1.25477,-6.77,12467.37,AUDNZD
1172,2009.02.03 04:49,close,462,0.01,1.25477,-11.36,12456.01,AUDNZD
1173,2009.02.03 04:49,close,455,0.01,1.25477,-13.99,12442.02,AUDNZD
1174,2009.02.03 04:49,close,452,0.01,1.25477,-11.78,12430.24,AUDNZD
1175,2009.02.03 04:49,close,445,0.01,1.25477,-10.65,12419.59,AUDNZD
1176,2009.02.03 04:49,close,438,0.01,1.25477,-11.66,12407.93,AUDNZD
1177,2009.02.03 04:49,close,431,0.01,1.25477,-17.07,12390.86,AUDNZD
1178,2009.02.03 04:49,close,423,0.01,1.25477,-17.93,12372.93,AUDNZD
1179,2009.02.03 04:49,close,417,0.01,1.25477,-17.76,12355.17,AUDNZD
1180,2009.02.03 04:49,close,600,0.01,0.64145,14.35,12369.52,AUDUSD
1181,2009.02.03 04:49,close,591,0.01,0.64145,14.17,12383.69,AUDUSD
1182,2009.02.03 04:49,close,590,0.01,0.64145,14.14,12397.83,AUDUSD
1183,2009.02.03 04:49,close,579,0.01,0.64145,9.33,12407.16,AUDUSD
1184,2009.02.03 04:49,close,570,0.01,0.64145,5.44,12412.60,AUDUSD
1185,2009.02.03 04:49,close,564,0.01,0.64145,5.41,12418.01,AUDUSD
1186,2009.02.03 04:49,close,557,0.01,0.64145,6.05,12424.06,AUDUSD
1187,2009.02.03 04:49,close,551,0.01,0.64145,4.75,12428.81,AUDUSD
1188,2009.02.03 04:49,close,539,0.01,0.64145,3.85,12432.66,AUDUSD
1189,2009.02.03 04:49,close,538,0.07,0.64145,27.30,12459.96,AUDUSD
1190,2009.02.03 04:49,close,491,0.01,0.64145,-5.60,12454.36,AUDUSD
1191,2009.02.03 04:49,close,487,0.01,0.64145,-6.20,12448.16,AUDUSD
1192,2009.02.03 04:49,close,486,0.02,0.64145,-12.20,12435.96,AUDUSD
1193,2009.02.03 04:49,close,466,0.01,0.64145,-10.23,12425.73,AUDUSD
1194,2009.02.03 04:49,close,460,0.01,0.64145,-10.44,12415.29,AUDUSD
1195,2009.02.03 04:49,close,453,0.01,0.64145,-12.89,12402.40,AUDUSD
1196,2009.02.03 04:49,close,446,0.01,0.64145,-16.34,12386.06,AUDUSD
1197,2009.02.03 04:49,close,439,0.01,0.64145,-17.18,12368.88,AUDUSD
1198,2009.02.03 04:49,close,432,0.01,0.64145,-13.94,12354.94,AUDUSD
1199,2009.02.03 04:49,close,424,0.01,0.64145,-14.39,12340.55,AUDUSD
1200,2009.02.03 04:49,close,418,0.01,0.64145,-14.33,12326.22,AUDUSD
1201,2009.02.04 09:25,sell,601,0.01,2.24356,,,GBPAUD
1202,2009.02.04 09:29,sell,602,0.01,2.02306,,,EURAUD
1203,2009.02.04 09:30,buy,603,0.01,0.79575,,,AUDCAD
1204,2009.02.04 09:30,buy,604,0.01,0.73664,,,AUDCHF
1205,2009.02.04 09:30,buy,605,0.01,57.2510,,,AUDJPY
1206,2009.02.04 09:30,buy,606,0.01,1.26516,,,AUDNZD
1207,2009.02.04 09:30,buy,607,0.01,0.64298,,,AUDUSD
1208,2009.02.04 18:58,close,601,0.01,2.23152,12.41,12338.63,GBPAUD
1209,2009.02.04 19:02,close,602,0.01,1.97918,45.25,12383.88,EURAUD
1210,2009.02.04 19:03,close,603,0.01,0.79600,0.25,12384.13,AUDCAD
1211,2009.02.04 19:03,close,604,0.01,0.75218,16.61,12400.74,AUDCHF
1212,2009.02.04 19:03,close,605,0.01,58.1270,8.83,12409.57,AUDJPY
1213,2009.02.04 19:03,close,606,0.01,1.26890,3.19,12412.76,AUDNZD
1214,2009.02.04 19:03,close,607,0.01,0.64880,5.82,12418.58,AUDUSD
1215,2009.02.05 00:25,sell,608,0.01,1.99809,,,EURAUD
1216,2009.02.05 00:25,sell,609,0.01,2.24750,,,GBPAUD
1217,2009.02.05 00:28,buy,610,0.01,1.26002,,,AUDNZD
1218,2009.02.05 00:30,buy,611,0.01,0.79155,,,AUDCAD
1219,2009.02.05 00:30,buy,612,0.01,0.74424,,,AUDCHF
1220,2009.02.05 00:30,buy,613,0.01,57.3510,,,AUDJPY
1221,2009.02.05 00:30,buy,614,0.01,0.64228,,,AUDUSD
1222,2009.02.05 10:25,close,609,0.01,2.23600,11.85,12430.43,GBPAUD
1223,2009.02.05 10:28,close,610,0.01,1.26297,2.52,12432.95,AUDNZD
1224,2009.02.05 10:28,close,608,0.01,1.98764,10.77,12443.72,EURAUD
1225,2009.02.05 10:30,close,611,0.01,0.79250,0.94,12444.66,AUDCAD
1226,2009.02.05 10:30,close,612,0.01,0.75010,6.27,12450.93,AUDCHF
1227,2009.02.05 10:30,close,613,0.01,58.0200,6.75,12457.68,AUDJPY
1228,2009.02.05 10:30,close,614,0.01,0.64670,4.42,12462.10,AUDUSD
1229,2009.02.09 07:55,sell,615,0.01,1.93747,,,EURAUD
1230,2009.02.09 07:59,buy,616,0.01,0.81672,,,AUDCAD
1231,2009.02.09 07:59,buy,617,0.01,60.7890,,,AUDJPY
1232,2009.02.09 07:59,buy,618,0.01,1.26491,,,AUDNZD
1233,2009.02.09 07:59,sell,619,0.01,1.93644,,,EURAUD
1234,2009.02.09 07:59,sell,620,0.01,2.21596,,,GBPAUD
1235,2009.02.09 08:00,buy,621,0.01,0.77474,,,AUDCHF
1236,2009.02.09 08:00,buy,622,0.01,0.66638,,,AUDUSD
1237,2009.02.09 08:04,buy,623,0.01,0.81544,,,AUDCAD
1238,2009.02.09 08:04,buy,624,0.01,0.77331,,,AUDCHF
1239,2009.02.09 08:04,buy,625,0.01,60.5690,,,AUDJPY
1240,2009.02.09 08:04,buy,626,0.01,1.26280,,,AUDNZD
1241,2009.02.09 08:04,buy,627,0.01,0.66525,,,AUDUSD
1242,2009.02.09 08:04,sell,628,0.01,2.21728,,,GBPAUD
1243,2009.02.09 15:55,close,619,0.01,1.92334,13.51,12475.61,EURAUD
1244,2009.02.09 15:55,close,615,0.01,1.92334,14.57,12490.18,EURAUD
1245,2009.02.09 15:59,close,628,0.01,2.20058,17.22,12507.40,GBPAUD
1246,2009.02.09 15:59,close,620,0.01,2.20058,15.86,12523.26,GBPAUD
1247,2009.02.09 16:00,close,623,0.01,0.82810,12.55,12535.81,AUDCAD
1248,2009.02.09 16:00,close,616,0.01,0.82810,11.28,12547.09,AUDCAD
1249,2009.02.09 16:00,close,624,0.01,0.78285,10.20,12557.29,AUDCHF
1250,2009.02.09 16:00,close,621,0.01,0.78285,8.67,12565.96,AUDCHF
1251,2009.02.09 16:00,close,625,0.01,62.2050,16.50,12582.46,AUDJPY
1252,2009.02.09 16:00,close,617,0.01,62.2050,14.28,12596.74,AUDJPY
1253,2009.02.09 16:00,close,626,0.01,1.25580,-5.98,12590.76,AUDNZD
1254,2009.02.09 16:00,close,618,0.01,1.25580,-7.78,12582.98,AUDNZD
1255,2009.02.09 16:00,close,627,0.01,0.67895,13.70,12596.68,AUDUSD
1256,2009.02.09 16:00,close,622,0.01,0.67895,12.57,12609.25,AUDUSD
1257,2009.02.10 02:55,sell,629,0.01,1.91854,,,EURAUD
1258,2009.02.10 02:56,sell,630,0.01,2.20750,,,GBPAUD
1259,2009.02.10 02:59,buy,631,0.01,0.82031,,,AUDCAD
1260,2009.02.10 02:59,buy,632,0.01,0.78506,,,AUDCHF
1261,2009.02.10 03:00,buy,633,0.01,61.2240,,,AUDJPY
1262,2009.02.10 03:00,buy,634,0.01,1.25786,,,AUDNZD
1263,2009.02.10 03:00,buy,635,0.01,0.66999,,,AUDUSD
1264,2009.02.10 05:27,sell,636,0.01,1.91459,,,EURAUD
1265,2009.02.10 05:32,buy,637,0.01,0.81855,,,AUDCAD
1266,2009.02.10 05:32,buy,638,0.01,0.78632,,,AUDCHF
1267,2009.02.10 05:32,buy,639,0.01,61.1410,,,AUDJPY
1268,2009.02.10 05:32,buy,640,0.01,1.25768,,,AUDNZD
1269,2009.02.10 05:32,buy,641,0.01,0.66908,,,AUDUSD
1270,2009.02.10 05:32,sell,642,0.01,2.21686,,,GBPAUD
1271,2009.02.10 07:15,sell,643,0.01,1.91917,,,EURAUD
1272,2009.02.10 07:19,buy,644,0.01,1.25432,,,AUDNZD
1273,2009.02.10 07:19,sell,645,0.01,2.21599,,,GBPAUD
1274,2009.02.10 07:20,buy,646,0.01,0.81755,,,AUDCAD
1275,2009.02.10 07:20,buy,647,0.01,0.78572,,,AUDCHF
1276,2009.02.10 07:20,buy,648,0.01,61.0750,,,AUDJPY
1277,2009.02.10 07:20,buy,649,0.01,0.66885,,,AUDUSD
1278,2009.02.10 11:55,sell,650,0.01,2.21625,,,GBPAUD
1279,2009.02.10 11:55,sell,651,0.01,2.21619,,,GBPAUD
1280,2009.02.10 11:58,sell,652,0.01,1.93952,,,EURAUD
1281,2009.02.10 11:58,sell,653,0.01,1.93941,,,EURAUD
1282,2009.02.10 11:59,buy,654,0.01,0.77589,,,AUDCHF
1283,2009.02.10 11:59,buy,655,0.01,0.77584,,,AUDCHF
1284,2009.02.10 12:00,buy,656,0.01,0.82015,,,AUDCAD
1285,2009.02.10 12:00,buy,657,0.01,0.82027,,,AUDCAD
1286,2009.02.10 12:00,buy,658,0.01,60.9610,,,AUDJPY
1287,2009.02.10 12:00,buy,659,0.01,60.9760,,,AUDJPY
1288,2009.02.10 12:00,buy,660,0.01,1.24886,,,AUDNZD
1289,2009.02.10 12:00,buy,661,0.01,1.24884,,,AUDNZD
1290,2009.02.10 12:00,buy,662,0.01,0.66838,,,AUDUSD
1291,2009.02.10 12:00,buy,663,0.01,0.66847,,,AUDUSD
1292,2009.02.10 12:07,sell,664,0.01,2.21064,,,GBPAUD
1293,2009.02.10 12:12,buy,665,0.01,0.81971,,,AUDCAD
1294,2009.02.10 12:12,buy,666,0.01,0.77527,,,AUDCHF
1295,2009.02.10 12:12,buy,667,0.01,60.8330,,,AUDJPY
1296,2009.02.10 12:12,buy,668,0.01,1.24667,,,AUDNZD
1297,2009.02.10 12:12,buy,669,0.01,0.66721,,,AUDUSD
1298,2009.02.10 12:12,sell,670,0.01,1.94140,,,EURAUD
1299,2009.02.10 12:12,sell,671,0.01,2.21855,,,GBPAUD
1300,2009.02.10 12:15,sell,672,0.01,1.94377,,,EURAUD
1301,2009.02.10 12:16,buy,673,0.01,1.24931,,,AUDNZD
1302,2009.02.10 12:17,buy,674,0.01,0.81897,,,AUDCAD
1303,2009.02.10 12:17,buy,675,0.01,0.77379,,,AUDCHF
1304,2009.02.10 12:17,buy,676,0.01,0.66618,,,AUDUSD
1305,2009.02.10 12:18,buy,677,0.01,60.7510,,,AUDJPY
1306,2009.02.10 22:55,sell,678,0.01,1.97010,,,EURAUD
1307,2009.02.10 22:55,sell,679,0.01,1.97034,,,EURAUD
1308,2009.02.10 22:55,sell,680,0.01,1.97059,,,EURAUD
1309,2009.02.10 22:55,sell,681,0.01,1.97083,,,EURAUD
1310,2009.02.10 22:55,sell,682,0.01,1.97078,,,EURAUD
1311,2009.02.10 22:55,sell,683,0.01,1.97073,,,EURAUD
1312,2009.02.10 22:57,sell,684,0.01,2.21940,,,GBPAUD
1313,2009.02.10 22:57,sell,685,0.01,2.21980,,,GBPAUD
1314,2009.02.10 22:58,sell,686,0.01,2.22000,,,GBPAUD
1315,2009.02.10 22:58,sell,687,0.01,2.22030,,,GBPAUD
1316,2009.02.10 22:58,sell,688,0.01,2.22025,,,GBPAUD
1317,2009.02.10 22:58,sell,689,0.01,2.22020,,,GBPAUD
1318,2009.02.10 22:59,buy,690,0.01,0.81435,,,AUDCAD
1319,2009.02.10 22:59,buy,691,0.01,59.2110,,,AUDJPY
1320,2009.02.10 22:59,buy,692,0.01,1.25011,,,AUDNZD
1321,2009.02.10 22:59,sell,693,0.01,1.97240,,,EURAUD
1322,2009.02.10 23:00,buy,694,0.01,0.81415,,,AUDCAD
1323,2009.02.10 23:00,buy,695,0.01,0.81435,,,AUDCAD
1324,2009.02.10 23:00,buy,696,0.01,0.81430,,,AUDCAD
1325,2009.02.10 23:00,buy,697,0.01,0.81425,,,AUDCAD
1326,2009.02.10 23:00,buy,698,0.01,0.81445,,,AUDCAD
1327,2009.02.10 23:00,buy,699,0.01,0.75714,,,AUDCHF
1328,2009.02.10 23:00,buy,700,0.01,0.75726,,,AUDCHF
1329,2009.02.10 23:00,buy,701,0.01,0.75718,,,AUDCHF
1330,2009.02.10 23:00,buy,702,0.01,0.75726,,,AUDCHF
1331,2009.02.10 23:00,buy,703,0.01,0.75734,,,AUDCHF
1332,2009.02.10 23:00,buy,704,0.01,0.75701,,,AUDCHF
1333,2009.02.10 23:00,buy,705,0.01,59.2210,,,AUDJPY
1334,2009.02.10 23:00,buy,706,0.01,59.2220,,,AUDJPY
1335,2009.02.10 23:00,buy,707,0.01,59.2180,,,AUDJPY
1336,2009.02.10 23:00,buy,708,0.01,59.2130,,,AUDJPY
1337,2009.02.10 23:00,buy,709,0.01,59.2190,,,AUDJPY
1338,2009.02.10 23:00,buy,710,0.01,1.25021,,,AUDNZD
1339,2009.02.10 23:00,buy,711,0.01,1.25016,,,AUDNZD
1340,2009.02.10 23:00,buy,712,0.01,1.25023,,,AUDNZD
1341,2009.02.10 23:00,buy,713,0.01,1.25030,,,AUDNZD
1342,2009.02.10 23:00,buy,714,0.01,1.25001,,,AUDNZD
1343,2009.02.10 23:00,buy,715,0.05,0.65488,,,AUDUSD
1344,2009.02.10 23:00,buy,716,0.01,0.65489,,,AUDUSD
1345,2009.02.10 23:03,sell,717,0.01,2.22341,,,GBPAUD
1346,2009.02.10 23:04,buy,718,0.01,0.81335,,,AUDCAD
1347,2009.02.10 23:04,buy,719,0.01,0.75524,,,AUDCHF
1348,2009.02.10 23:04,buy,720,0.01,59.0930,,,AUDJPY
1349,2009.02.10 23:04,buy,721,0.01,1.24921,,,AUDNZD
1350,2009.02.10 23:04,buy,722,0.01,0.65308,,,AUDUSD
1351,2009.02.13 00:26,close,693,0.01,1.96594,7.15,12616.40,EURAUD
1352,2009.02.13 00:26,close,683,0.01,1.96594,5.43,12621.83,EURAUD
1353,2009.02.13 00:26,close,682,0.01,1.96594,5.48,12627.31,EURAUD
1354,2009.02.13 00:26,close,681,0.01,1.96594,5.53,12632.84,EURAUD
1355,2009.02.13 00:26,close,680,0.01,1.96594,5.28,12638.12,EURAUD
1356,2009.02.13 00:26,close,679,0.01,1.96594,5.03,12643.15,EURAUD
1357,2009.02.13 00:26,close,678,0.01,1.96594,4.78,12647.93,EURAUD
1358,2009.02.13 00:26,close,672,0.01,1.96594,-22.37,12625.56,EURAUD
1359,2009.02.13 00:26,close,670,0.01,1.96594,-24.81,12600.75,EURAUD
1360,2009.02.13 00:26,close,653,0.01,1.96594,-26.87,12573.88,EURAUD
1361,2009.02.13 00:26,close,652,0.01,1.96594,-26.75,12547.13,EURAUD
1362,2009.02.13 00:26,close,643,0.01,1.96594,-47.74,12499.39,EURAUD
1363,2009.02.13 00:26,close,636,0.01,1.96594,-52.46,12446.93,EURAUD
1364,2009.02.13 00:26,close,629,0.01,1.96594,-48.39,12398.54,EURAUD
1365,2009.02.13 00:31,close,718,0.01,0.81330,0.16,12398.70,AUDCAD
1366,2009.02.13 00:31,close,698,0.01,0.81330,-0.93,12397.77,AUDCAD
1367,2009.02.13 00:31,close,697,0.01,0.81330,-0.73,12397.04,AUDCAD
1368,2009.02.13 00:31,close,696,0.01,0.81330,-0.78,12396.26,AUDCAD
1369,2009.02.13 00:31,close,695,0.01,0.81330,-0.83,12395.43,AUDCAD
1370,2009.02.13 00:31,close,694,0.01,0.81330,-0.63,12394.80,AUDCAD
1371,2009.02.13 00:31,close,690,0.01,0.81330,-0.83,12393.97,AUDCAD
1372,2009.02.13 00:31,close,674,0.01,0.81330,-5.41,12388.56,AUDCAD
1373,2009.02.13 00:31,close,665,0.01,0.81330,-6.14,12382.42,AUDCAD
1374,2009.02.13 00:31,close,657,0.01,0.81330,-6.70,12375.72,AUDCAD
1375,2009.02.13 00:31,close,656,0.01,0.81330,-6.58,12369.14,AUDCAD
1376,2009.02.13 00:31,close,646,0.01,0.81330,-4.00,12365.14,AUDCAD
1377,2009.02.13 00:31,close,637,0.01,0.81330,-4.99,12360.15,AUDCAD
1378,2009.02.13 00:31,close,631,0.01,0.81330,-6.74,12353.41,AUDCAD
1379,2009.02.13 00:31,close,719,0.01,0.76040,5.84,12359.25,AUDCHF
1380,2009.02.13 00:31,close,704,0.01,0.76040,3.95,12363.20,AUDCHF
1381,2009.02.13 00:31,close,703,0.01,0.76040,3.59,12366.79,AUDCHF
1382,2009.02.13 00:31,close,702,0.01,0.76040,3.68,12370.47,AUDCHF
1383,2009.02.13 00:31,close,701,0.01,0.76040,3.77,12374.24,AUDCHF
1384,2009.02.13 00:31,close,700,0.01,0.76040,3.68,12377.92,AUDCHF
1385,2009.02.13 00:31,close,699,0.01,0.76040,3.81,12381.73,AUDCHF
1386,2009.02.13 00:31,close,675,0.01,0.76040,-13.99,12367.74,AUDCHF
1387,2009.02.13 00:31,close,666,0.01,0.76040,-15.57,12352.17,AUDCHF
1388,2009.02.13 00:31,close,655,0.01,0.76040,-16.18,12335.99,AUDCHF
1389,2009.02.13 00:31,close,654,0.01,0.76040,-16.24,12319.75,AUDCHF
1390,2009.02.13 00:31,close,647,0.01,0.76040,-26.74,12293.01,AUDCHF
1391,2009.02.13 00:31,close,638,0.01,0.76040,-27.39,12265.62,AUDCHF
1392,2009.02.13 00:31,close,632,0.01,0.76040,-26.04,12239.58,AUDCHF
1393,2009.02.13 00:31,close,720,0.01,59.4000,3.46,12243.04,AUDJPY
1394,2009.02.13 00:31,close,709,0.01,59.4000,2.19,12245.23,AUDJPY
1395,2009.02.13 00:31,close,708,0.01,59.4000,2.25,12247.48,AUDJPY
1396,2009.02.13 00:31,close,707,0.01,59.4000,2.20,12249.68,AUDJPY
1397,2009.02.13 00:31,close,706,0.01,59.4000,2.16,12251.84,AUDJPY
1398,2009.02.13 00:31,close,705,0.01,59.4000,2.17,12254.01,AUDJPY
1399,2009.02.13 00:31,close,691,0.01,59.4000,2.27,12256.28,AUDJPY
1400,2009.02.13 00:31,close,677,0.01,59.4000,-13.26,12243.02,AUDJPY
1401,2009.02.13 00:31,close,667,0.01,59.4000,-14.09,12228.93,AUDJPY
1402,2009.02.13 00:31,close,659,0.01,59.4000,-15.53,12213.40,AUDJPY
1403,2009.02.13 00:31,close,658,0.01,59.4000,-15.38,12198.02,AUDJPY
1404,2009.02.13 00:31,close,648,0.01,59.4000,-16.53,12181.49,AUDJPY
1405,2009.02.13 00:31,close,639,0.01,59.4000,-17.19,12164.30,AUDJPY
1406,2009.02.13 00:31,close,633,0.01,59.4000,-18.03,12146.27,AUDJPY
1407,2009.02.13 00:31,close,721,0.01,1.25230,2.63,12148.90,AUDNZD
1408,2009.02.13 00:31,close,714,0.01,1.25230,1.94,12150.84,AUDNZD
1409,2009.02.13 00:31,close,713,0.01,1.25230,1.70,12152.54,AUDNZD
1410,2009.02.13 00:31,close,712,0.01,1.25230,1.76,12154.30,AUDNZD
1411,2009.02.13 00:31,close,711,0.01,1.25230,1.82,12156.12,AUDNZD
1412,2009.02.13 00:31,close,710,0.01,1.25230,1.77,12157.89,AUDNZD
1413,2009.02.13 00:31,close,692,0.01,1.25230,1.86,12159.75,AUDNZD
1414,2009.02.13 00:31,close,673,0.01,1.25230,2.54,12162.29,AUDNZD
1415,2009.02.13 00:31,close,668,0.01,1.25230,4.80,12167.09,AUDNZD
1416,2009.02.13 00:31,close,661,0.01,1.25230,2.94,12170.03,AUDNZD
1417,2009.02.13 00:31,close,660,0.01,1.25230,2.93,12172.96,AUDNZD
1418,2009.02.13 00:31,close,644,0.01,1.25230,-1.74,12171.22,AUDNZD
1419,2009.02.13 00:31,close,640,0.01,1.25230,-4.60,12166.62,AUDNZD
1420,2009.02.13 00:31,close,634,0.01,1.25230,-4.76,12161.86,AUDNZD
1421,2009.02.13 00:31,close,722,0.01,0.65460,1.85,12163.71,AUDUSD
1422,2009.02.13 00:31,close,716,0.01,0.65460,0.04,12163.75,AUDUSD
1423,2009.02.13 00:31,close,715,0.05,0.65460,0.23,12163.98,AUDUSD
1424,2009.02.13 00:31,close,676,0.01,0.65460,-11.26,12152.72,AUDUSD
1425,2009.02.13 00:31,close,669,0.01,0.65460,-12.29,12140.43,AUDUSD
1426,2009.02.13 00:31,close,663,0.01,0.65460,-13.55,12126.88,AUDUSD
1427,2009.02.13 00:31,close,662,0.01,0.65460,-13.46,12113.42,AUDUSD
1428,2009.02.13 00:31,close,649,0.01,0.65460,-13.93,12099.49,AUDUSD
1429,2009.02.13 00:31,close,641,0.01,0.65460,-14.16,12085.33,AUDUSD
1430,2009.02.13 00:31,close,635,0.01,0.65460,-15.07,12070.26,AUDUSD
1431,2009.02.13 00:31,close,717,0.01,2.17740,47.93,12118.19,GBPAUD
1432,2009.02.13 00:31,close,689,0.01,2.17740,44.62,12162.81,GBPAUD
1433,2009.02.13 00:31,close,688,0.01,2.17740,44.68,12207.49,GBPAUD
1434,2009.02.13 00:31,close,687,0.01,2.17740,44.73,12252.22,GBPAUD
1435,2009.02.13 00:31,close,686,0.01,2.17740,44.42,12296.64,GBPAUD
1436,2009.02.13 00:31,close,685,0.01,2.17740,44.21,12340.85,GBPAUD
1437,2009.02.13 00:31,close,684,0.01,2.17740,43.80,12384.65,GBPAUD
1438,2009.02.13 00:31,close,671,0.01,2.17740,42.92,12427.57,GBPAUD
1439,2009.02.13 00:31,close,664,0.01,2.17740,34.77,12462.34,GBPAUD
1440,2009.02.13 00:31,close,651,0.01,2.17740,40.49,12502.83,GBPAUD
1441,2009.02.13 00:31,close,650,0.01,2.17740,40.55,12543.38,GBPAUD
1442,2009.02.13 00:31,close,645,0.01,2.17740,40.28,12583.66,GBPAUD
1443,2009.02.13 00:31,close,642,0.01,2.17740,41.18,12624.84,GBPAUD
1444,2009.02.13 00:31,close,630,0.01,2.17740,31.53,12656.37,GBPAUD
1445,2009.02.16 00:55,sell,723,0.01,1.95945,,,EURAUD
1446,2009.02.16 00:59,buy,724,0.01,0.75934,,,AUDCHF
1447,2009.02.16 00:59,sell,725,0.01,2.18065,,,GBPAUD
1448,2009.02.16 01:00,buy,726,0.01,0.81075,,,AUDCAD
1449,2009.02.16 01:00,buy,727,0.01,59.7010,,,AUDJPY
1450,2009.02.16 01:00,buy,728,0.01,1.25296,,,AUDNZD
1451,2009.02.16 01:00,buy,729,0.01,0.65268,,,AUDUSD
1452,2009.02.16 07:25,sell,730,0.01,1.96120,,,EURAUD
1453,2009.02.16 07:29,sell,731,0.01,2.18465,,,GBPAUD
1454,2009.02.16 07:30,buy,732,0.01,0.80825,,,AUDCAD
1455,2009.02.16 07:30,buy,733,0.01,0.75874,,,AUDCHF
1456,2009.02.16 07:30,buy,734,0.01,59.6410,,,AUDJPY
1457,2009.02.16 07:30,buy,735,0.01,1.25286,,,AUDNZD
1458,2009.02.16 07:30,buy,736,0.01,0.65008,,,AUDUSD
1459,2009.02.16 07:34,sell,737,0.01,1.96093,,,EURAUD
1460,2009.02.16 07:38,sell,738,0.01,2.18566,,,GBPAUD
1461,2009.02.16 07:39,buy,739,0.01,0.80635,,,AUDCAD
1462,2009.02.16 07:39,buy,740,0.01,0.75858,,,AUDCHF
1463,2009.02.16 07:39,buy,741,0.01,59.4910,,,AUDJPY
1464,2009.02.16 07:39,buy,742,0.01,1.25084,,,AUDNZD
1465,2009.02.16 07:39,buy,743,0.01,0.64858,,,AUDUSD
1466,2009.02.16 11:43,sell,744,0.01,2.19865,,,GBPAUD
1467,2009.02.16 11:48,buy,745,0.01,0.80813,,,AUDCAD
1468,2009.02.16 11:48,buy,746,0.01,0.75837,,,AUDCHF
1469,2009.02.16 11:48,buy,747,0.01,59.5730,,,AUDJPY
1470,2009.02.16 11:48,buy,748,0.01,1.25291,,,AUDNZD
1471,2009.02.16 11:48,buy,749,0.01,0.64928,,,AUDUSD
1472,2009.02.16 11:48,sell,750,0.01,1.96718,,,EURAUD
1473,2009.02.17 07:25,sell,751,0.01,1.96790,,,EURAUD
1474,2009.02.17 07:25,sell,752,0.01,1.96832,,,EURAUD
1475,2009.02.17 07:25,sell,753,0.01,1.96787,,,EURAUD
1476,2009.02.17 07:28,sell,754,0.01,2.21175,,,GBPAUD
1477,2009.02.17 07:29,buy,755,0.01,0.80305,,,AUDCAD
1478,2009.02.17 07:29,buy,756,0.01,59.3580,,,AUDJPY
1479,2009.02.17 07:29,buy,757,0.01,59.3510,,,AUDJPY
1480,2009.02.17 07:29,sell,758,0.01,2.21155,,,GBPAUD
1481,2009.02.17 07:30,buy,759,0.01,0.80295,,,AUDCAD
1482,2009.02.17 07:30,buy,760,0.01,0.80255,,,AUDCAD
1483,2009.02.17 07:30,buy,761,0.01,0.75424,,,AUDCHF
1484,2009.02.17 07:30,buy,762,0.01,0.75413,,,AUDCHF
1485,2009.02.17 07:30,buy,763,0.01,0.75382,,,AUDCHF
1486,2009.02.17 07:30,buy,764,0.01,59.3570,,,AUDJPY
1487,2009.02.17 07:30,buy,765,0.01,1.25566,,,AUDNZD
1488,2009.02.17 07:30,buy,766,0.01,1.25543,,,AUDNZD
1489,2009.02.17 07:30,buy,767,0.01,1.25565,,,AUDNZD
1490,2009.02.17 07:30,buy,768,0.01,0.64238,,,AUDUSD
1491,2009.02.17 07:30,buy,769,0.01,0.64227,,,AUDUSD
1492,2009.02.17 07:30,buy,770,0.01,0.64208,,,AUDUSD
1493,2009.02.17 07:30,sell,771,0.01,2.21240,,,GBPAUD
1494,2009.02.17 07:34,sell,772,0.01,1.97075,,,EURAUD
1495,2009.02.17 07:36,sell,773,0.01,2.21311,,,GBPAUD
1496,2009.02.17 07:37,buy,774,0.01,1.25748,,,AUDNZD
1497,2009.02.17 07:39,buy,775,0.01,0.80076,,,AUDCAD
1498,2009.02.17 07:39,buy,776,0.01,0.75250,,,AUDCHF
1499,2009.02.17 07:39,buy,777,0.01,59.1740,,,AUDJPY
1500,2009.02.17 07:39,buy,778,0.01,0.64054,,,AUDUSD
1501,2009.02.17 11:05,sell,779,0.01,2.22357,,,GBPAUD
1502,2009.02.17 11:08,sell,780,0.01,1.96898,,,EURAUD
1503,2009.02.17 11:08,sell,781,0.01,2.22353,,,GBPAUD
1504,2009.02.17 11:10,buy,782,0.01,0.80683,,,AUDCAD
1505,2009.02.17 11:10,buy,783,0.01,0.75020,,,AUDCHF
1506,2009.02.17 11:10,buy,784,0.01,58.8710,,,AUDJPY
1507,2009.02.17 11:10,buy,785,0.01,1.25451,,,AUDNZD
1508,2009.02.17 11:10,buy,786,0.01,0.64107,,,AUDUSD
1509,2009.02.17 11:13,buy,787,0.01,0.80715,,,AUDCAD
1510,2009.02.17 11:13,buy,788,0.01,0.74882,,,AUDCHF
1511,2009.02.17 11:13,buy,789,0.01,58.7570,,,AUDJPY
1512,2009.02.17 11:13,buy,790,0.01,1.25506,,,AUDNZD
1513,2009.02.17 11:13,buy,791,0.01,0.63987,,,AUDUSD
1514,2009.02.17 11:13,sell,792,0.01,1.97421,,,EURAUD
1515,2009.02.17 15:25,sell,793,0.01,2.23250,,,GBPAUD
1516,2009.02.17 15:29,buy,794,0.01,0.80618,,,AUDCAD
1517,2009.02.17 15:29,buy,795,0.01,0.74993,,,AUDCHF
1518,2009.02.17 15:29,buy,796,0.01,58.6540,,,AUDJPY
1519,2009.02.17 15:29,buy,797,0.01,1.25588,,,AUDNZD
1520,2009.02.17 15:29,sell,798,0.01,1.97600,,,EURAUD
1521,2009.02.17 15:30,buy,799,0.01,0.63768,,,AUDUSD
1522,2009.02.17 15:48,sell,800,0.01,2.23197,,,GBPAUD
1523,2009.02.17 15:52,sell,801,0.01,1.97823,,,EURAUD
1524,2009.02.17 15:53,buy,802,0.01,0.80516,,,AUDCAD
1525,2009.02.17 15:53,buy,803,0.01,0.74841,,,AUDCHF
1526,2009.02.17 15:53,buy,804,0.01,58.5620,,,AUDJPY
1527,2009.02.17 15:53,buy,805,0.01,1.25462,,,AUDNZD
1528,2009.02.17 15:53,buy,806,0.01,0.63655,,,AUDUSD
1529,2009.02.18 00:08,sell,807,0.01,1.97638,,,EURAUD
1530,2009.02.18 00:10,sell,808,0.01,2.23637,,,GBPAUD
1531,2009.02.18 00:13,buy,809,0.01,0.80448,,,AUDCAD
1532,2009.02.18 00:13,buy,810,0.01,0.74389,,,AUDCHF
1533,2009.02.18 00:13,buy,811,0.01,58.7680,,,AUDJPY
1534,2009.02.18 00:13,buy,812,0.01,1.25092,,,AUDNZD
1535,2009.02.18 00:13,buy,813,0.01,0.63611,,,AUDUSD
1536,2009.02.19 04:03,close,807,0.01,1.96005,17.12,12673.49,EURAUD
1537,2009.02.19 04:03,close,801,0.01,1.96005,19.13,12692.62,EURAUD
1538,2009.02.19 04:03,close,798,0.01,1.96005,16.83,12709.45,EURAUD
1539,2009.02.19 04:03,close,792,0.01,1.96005,14.99,12724.44,EURAUD
1540,2009.02.19 04:03,close,780,0.01,1.96005,9.59,12734.03,EURAUD
1541,2009.02.19 04:03,close,772,0.01,1.96005,11.42,12745.45,EURAUD
1542,2009.02.19 04:03,close,753,0.01,1.96005,8.45,12753.90,EURAUD
1543,2009.02.19 04:03,close,752,0.01,1.96005,8.91,12762.81,EURAUD
1544,2009.02.19 04:03,close,751,0.01,1.96005,8.48,12771.29,EURAUD
1545,2009.02.19 04:03,close,750,0.01,1.96005,7.84,12779.13,EURAUD
1546,2009.02.19 04:03,close,737,0.01,1.96005,1.39,12780.52,EURAUD
1547,2009.02.19 04:03,close,730,0.01,1.96005,1.67,12782.19,EURAUD
1548,2009.02.19 04:03,close,723,0.01,1.96005,-0.13,12782.06,EURAUD
1549,2009.02.19 04:07,close,810,0.01,0.75215,9.02,12791.08,AUDCHF
1550,2009.02.19 04:07,close,803,0.01,0.75215,4.26,12795.34,AUDCHF
1551,2009.02.19 04:07,close,795,0.01,0.75215,2.64,12797.98,AUDCHF
1552,2009.02.19 04:07,close,788,0.01,0.75215,3.82,12801.80,AUDCHF
1553,2009.02.19 04:07,close,783,0.01,0.75215,2.35,12804.15,AUDCHF
1554,2009.02.19 04:07,close,776,0.01,0.75215,-0.11,12804.04,AUDCHF
1555,2009.02.19 04:07,close,763,0.01,0.75215,-1.52,12802.52,AUDCHF
1556,2009.02.19 04:07,close,762,0.01,0.75215,-1.85,12800.67,AUDCHF
1557,2009.02.19 04:07,close,761,0.01,0.75215,-1.97,12798.70,AUDCHF
1558,2009.02.19 04:07,close,746,0.01,0.75215,-6.33,12792.37,AUDCHF
1559,2009.02.19 04:07,close,740,0.01,0.75215,-6.55,12785.82,AUDCHF
1560,2009.02.19 04:07,close,733,0.01,0.75215,-6.72,12779.10,AUDCHF
1561,2009.02.19 04:07,close,724,0.01,0.75215,-7.36,12771.74,AUDCHF
1562,2009.02.19 04:07,close,811,0.01,60.0100,12.75,12784.49,AUDJPY
1563,2009.02.19 04:07,close,804,0.01,60.0100,14.89,12799.38,AUDJPY
1564,2009.02.19 04:07,close,796,0.01,60.0100,13.97,12813.35,AUDJPY
1565,2009.02.19 04:07,close,789,0.01,60.0100,12.93,12826.28,AUDJPY
1566,2009.02.19 04:07,close,784,0.01,60.0100,11.78,12838.06,AUDJPY
1567,2009.02.19 04:07,close,777,0.01,60.0100,8.72,12846.78,AUDJPY
1568,2009.02.19 04:07,close,764,0.01,60.0100,6.88,12853.66,AUDJPY
1569,2009.02.19 04:07,close,757,0.01,60.0100,6.94,12860.60,AUDJPY
1570,2009.02.19 04:07,close,756,0.01,60.0100,6.87,12867.47,AUDJPY
1571,2009.02.19 04:07,close,747,0.01,60.0100,4.77,12872.24,AUDJPY
1572,2009.02.19 04:07,close,741,0.01,60.0100,5.60,12877.84,AUDJPY
1573,2009.02.19 04:07,close,734,0.01,60.0100,4.08,12881.92,AUDJPY
1574,2009.02.19 04:07,close,727,0.01,60.0100,3.48,12885.40,AUDJPY
1575,2009.02.19 04:07,close,812,0.01,1.25270,1.51,12886.91,AUDNZD
1576,2009.02.19 04:07,close,805,0.01,1.25270,-1.65,12885.26,AUDNZD
1577,2009.02.19 04:07,close,797,0.01,1.25270,-2.73,12882.53,AUDNZD
1578,2009.02.19 04:07,close,790,0.01,1.25270,-2.03,12880.50,AUDNZD
1579,2009.02.19 04:07,close,785,0.01,1.25270,-1.56,12878.94,AUDNZD
1580,2009.02.19 04:07,close,774,0.01,1.25270,-4.09,12874.85,AUDNZD
1581,2009.02.19 04:07,close,767,0.01,1.25270,-2.53,12872.32,AUDNZD
1582,2009.02.19 04:07,close,766,0.01,1.25270,-2.34,12869.98,AUDNZD
1583,2009.02.19 04:07,close,765,0.01,1.25270,-2.54,12867.44,AUDNZD
1584,2009.02.19 04:07,close,748,0.01,1.25270,-0.19,12867.25,AUDNZD
1585,2009.02.19 04:07,close,742,0.01,1.25270,1.58,12868.83,AUDNZD
1586,2009.02.19 04:07,close,735,0.01,1.25270,-0.15,12868.68,AUDNZD
1587,2009.02.19 04:07,close,728,0.01,1.25270,-0.23,12868.45,AUDNZD
1588,2009.02.19 04:08,close,809,0.01,0.80651,2.15,12870.60,AUDCAD
1589,2009.02.19 04:08,close,802,0.01,0.80651,1.51,12872.11,AUDCAD
1590,2009.02.19 04:08,close,794,0.01,0.80651,0.50,12872.61,AUDCAD
1591,2009.02.19 04:08,close,787,0.01,0.80651,-0.46,12872.15,AUDCAD
1592,2009.02.19 04:08,close,782,0.01,0.80651,-0.14,12872.01,AUDCAD
1593,2009.02.19 04:08,close,775,0.01,0.80651,5.87,12877.88,AUDCAD
1594,2009.02.19 04:08,close,760,0.01,0.80651,4.10,12881.98,AUDCAD
1595,2009.02.19 04:08,close,759,0.01,0.80651,3.70,12885.68,AUDCAD
1596,2009.02.19 04:08,close,755,0.01,0.80651,3.60,12889.28,AUDCAD
1597,2009.02.19 04:08,close,745,0.01,0.80651,-1.39,12887.89,AUDCAD
1598,2009.02.19 04:08,close,739,0.01,0.80651,0.37,12888.26,AUDCAD
1599,2009.02.19 04:08,close,732,0.01,0.80651,-1.51,12886.75,AUDCAD
1600,2009.02.19 04:08,close,726,0.01,0.80651,-3.99,12882.76,AUDCAD
1601,2009.02.19 04:08,close,813,0.01,0.64095,5.04,12887.80,AUDUSD
1602,2009.02.19 04:08,close,806,0.01,0.64095,4.66,12892.46,AUDUSD
1603,2009.02.19 04:08,close,799,0.01,0.64095,3.53,12895.99,AUDUSD
1604,2009.02.19 04:08,close,791,0.01,0.64095,1.34,12897.33,AUDUSD
1605,2009.02.19 04:08,close,786,0.01,0.64095,0.14,12897.47,AUDUSD
1606,2009.02.19 04:08,close,778,0.01,0.64095,0.67,12898.14,AUDUSD
1607,2009.02.19 04:08,close,770,0.01,0.64095,-0.87,12897.27,AUDUSD
1608,2009.02.19 04:08,close,769,0.01,0.64095,-1.06,12896.21,AUDUSD
1609,2009.02.19 04:08,close,768,0.01,0.64095,-1.17,12895.04,AUDUSD
1610,2009.02.19 04:08,close,749,0.01,0.64095,-8.01,12887.03,AUDUSD
1611,2009.02.19 04:08,close,743,0.01,0.64095,-7.30,12879.73,AUDUSD
1612,2009.02.19 04:08,close,736,0.01,0.64095,-8.81,12870.92,AUDUSD
1613,2009.02.19 04:08,close,729,0.01,0.64095,-11.41,12859.51,AUDUSD
1614,2009.02.19 11:40,close,808,0.01,2.21161,25.83,12885.34,GBPAUD
1615,2009.02.19 11:40,close,800,0.01,2.21161,21.39,12906.73,GBPAUD
1616,2009.02.19 11:40,close,793,0.01,2.21161,21.94,12928.67,GBPAUD
1617,2009.02.19 11:40,close,781,0.01,2.21161,12.69,12941.36,GBPAUD
1618,2009.02.19 11:40,close,779,0.01,2.21161,12.73,12954.09,GBPAUD
1619,2009.02.19 11:40,close,773,0.01,2.21161,1.94,12956.03,GBPAUD
1620,2009.02.19 11:40,close,771,0.01,2.21161,1.21,12957.24,GBPAUD
1621,2009.02.19 11:40,close,758,0.01,2.21161,0.34,12957.58,GBPAUD
1622,2009.02.19 11:40,close,754,0.01,2.21161,0.54,12958.12,GBPAUD
1623,2009.02.19 11:40,close,744,0.01,2.21161,-12.88,12945.24,GBPAUD
1624,2009.02.19 11:40,close,738,0.01,2.21161,-26.27,12918.97,GBPAUD
1625,2009.02.19 11:40,close,731,0.01,2.21161,-27.31,12891.66,GBPAUD
1626,2009.02.19 11:40,close,725,0.01,2.21161,-31.44,12860.22,GBPAUD
1627,2009.02.20 08:25,sell,814,0.01,1.97470,,,EURAUD
1628,2009.02.20 08:29,buy,815,0.01,1.26606,,,AUDNZD
1629,2009.02.20 08:30,buy,816,0.01,0.80365,,,AUDCAD
1630,2009.02.20 08:30,buy,817,0.01,0.75274,,,AUDCHF
1631,2009.02.20 08:30,buy,818,0.01,60.0110,,,AUDJPY
1632,2009.02.20 08:30,buy,819,0.01,0.63778,,,AUDUSD
1633,2009.02.20 08:30,sell,820,0.01,2.22945,,,GBPAUD
1634,2009.02.24 07:25,close,814,0.01,1.96927,5.80,12866.02,EURAUD
1635,2009.02.24 07:30,close,816,0.01,0.80638,2.80,12868.82,AUDCAD
1636,2009.02.24 07:30,close,817,0.01,0.75470,2.22,12871.04,AUDCHF
1637,2009.02.24 07:30,close,818,0.01,61.5500,15.67,12886.71,AUDJPY
1638,2009.02.24 07:30,close,815,0.01,1.26135,-4.03,12882.68,AUDNZD
1639,2009.02.24 07:30,close,819,0.01,0.64625,8.60,12891.28,AUDUSD
1640,2009.02.24 07:30,close,820,0.01,2.25323,-24.32,12866.96,GBPAUD
1641,2009.02.26 23:55,buy,821,0.01,63.6960,,,AUDJPY
1642,2009.02.26 23:56,buy,822,0.01,0.81115,,,AUDCAD
1643,2009.02.26 23:56,buy,823,0.01,1.27531,,,AUDNZD
1644,2009.02.26 23:56,sell,824,0.01,1.96790,,,EURAUD
1645,2009.02.26 23:56,sell,825,0.01,2.20867,,,GBPAUD
1646,2009.02.26 23:57,buy,826,0.01,0.75398,,,AUDCHF
1647,2009.02.27 00:00,buy,827,0.01,0.64756,,,AUDUSD
1648,2009.02.27 02:55,sell,828,0.01,1.97004,,,EURAUD
1649,2009.02.27 02:59,buy,829,0.01,0.80970,,,AUDCAD
1650,2009.02.27 02:59,buy,830,0.01,63.0950,,,AUDJPY
1651,2009.02.27 02:59,sell,831,0.01,2.21166,,,GBPAUD
1652,2009.02.27 03:00,buy,832,0.01,0.75237,,,AUDCHF
1653,2009.02.27 03:00,buy,833,0.01,1.27648,,,AUDNZD
1654,2009.02.27 03:00,buy,834,0.01,0.64546,,,AUDUSD
1655,2009.02.27 09:02,sell,835,0.01,1.97043,,,EURAUD
1656,2009.02.27 09:05,sell,836,0.01,2.20853,,,GBPAUD
1657,2009.02.27 09:07,buy,837,0.01,0.80797,,,AUDCAD
1658,2009.02.27 09:07,buy,838,0.01,0.75383,,,AUDCHF
1659,2009.02.27 09:07,buy,839,0.01,62.7560,,,AUDJPY
1660,2009.02.27 09:07,buy,840,0.01,1.27367,,,AUDNZD
1661,2009.02.27 09:07,buy,841,0.01,0.64311,,,AUDUSD
1662,2009.02.27 15:55,sell,842,0.01,1.97598,,,EURAUD
1663,2009.02.27 15:55,sell,843,0.01,1.97596,,,EURAUD
1664,2009.02.27 15:59,buy,844,0.01,0.81085,,,AUDCAD
1665,2009.02.27 15:59,buy,845,0.01,0.81083,,,AUDCAD
1666,2009.02.27 15:59,buy,846,0.01,0.74792,,,AUDCHF
1667,2009.02.27 15:59,buy,847,0.01,0.74791,,,AUDCHF
1668,2009.02.27 15:59,buy,848,0.01,62.5670,,,AUDJPY
1669,2009.02.27 15:59,buy,849,0.01,62.5660,,,AUDJPY
1670,2009.02.27 15:59,buy,850,0.01,1.27238,,,AUDNZD
1671,2009.02.27 15:59,buy,851,0.01,1.27235,,,AUDNZD
1672,2009.02.27 15:59,sell,852,0.01,2.21521,,,GBPAUD
1673,2009.02.27 15:59,sell,853,0.01,2.21532,,,GBPAUD
1674,2009.02.27 16:00,buy,854,0.01,0.63973,,,AUDUSD
1675,2009.02.27 16:00,buy,855,0.01,0.63966,,,AUDUSD
1676,2009.02.27 16:00,sell,856,0.01,1.97616,,,EURAUD
1677,2009.02.27 16:05,buy,857,0.01,0.80997,,,AUDCAD
1678,2009.02.27 16:05,buy,858,0.01,0.74787,,,AUDCHF
1679,2009.02.27 16:05,buy,859,0.01,62.6190,,,AUDJPY
1680,2009.02.27 16:05,buy,860,0.01,1.27149,,,AUDNZD
1681,2009.02.27 16:05,buy,861,0.01,0.63948,,,AUDUSD
1682,2009.02.27 16:05,sell,862,0.01,1.97726,,,EURAUD
1683,2009.02.27 16:05,sell,863,0.01,2.22253,,,GBPAUD
1684,2009.02.27 16:10,buy,864,0.01,0.80827,,,AUDCAD
1685,2009.02.27 16:10,buy,865,0.01,0.74655,,,AUDCHF
1686,2009.02.27 16:10,buy,866,0.01,62.3990,,,AUDJPY
1687,2009.02.27 16:10,buy,867,0.01,1.27208,,,AUDNZD
1688,2009.02.27 16:10,buy,868,0.01,0.63789,,,AUDUSD
1689,2009.02.27 16:10,sell,869,0.01,2.22491,,,GBPAUD
1690,2009.03.02 00:55,sell,870,0.01,1.98387,,,EURAUD
1691,2009.03.02 00:55,sell,871,0.01,1.98396,,,EURAUD
1692,2009.03.02 00:59,buy,872,0.01,61.6360,,,AUDJPY
1693,2009.03.02 00:59,sell,873,0.01,2.24323,,,GBPAUD
1694,2009.03.02 00:59,sell,874,0.01,2.24326,,,GBPAUD
1695,2009.03.02 01:00,buy,875,0.01,0.81163,,,AUDCAD
1696,2009.03.02 01:00,buy,876,0.01,0.81178,,,AUDCAD
1697,2009.03.02 01:00,buy,877,0.01,0.74473,,,AUDCHF
1698,2009.03.02 01:00,buy,878,0.01,0.74480,,,AUDCHF
1699,2009.03.02 01:00,buy,879,0.01,61.6290,,,AUDJPY
1700,2009.03.02 01:00,buy,880,0.01,1.27886,,,AUDNZD
1701,2009.03.02 01:00,buy,881,0.01,1.27895,,,AUDNZD
1702,2009.03.02 01:00,buy,882,0.01,0.63424,,,AUDUSD
1703,2009.03.02 01:00,buy,883,0.01,0.63428,,,AUDUSD
1704,2009.03.02 02:32,sell,884,0.01,1.98858,,,EURAUD
1705,2009.03.02 02:32,sell,885,0.01,1.98855,,,EURAUD
1706,2009.03.02 02:35,sell,886,0.01,2.24986,,,GBPAUD
1707,2009.03.02 02:35,sell,887,0.01,2.24988,,,GBPAUD
1708,2009.03.02 02:37,buy,888,0.01,0.80932,,,AUDCAD
1709,2009.03.02 02:37,buy,889,0.01,0.80930,,,AUDCAD
1710,2009.03.02 02:37,buy,890,0.01,0.74241,,,AUDCHF
1711,2009.03.02 02:37,buy,891,0.01,0.74251,,,AUDCHF
1712,2009.03.02 02:37,buy,892,0.01,61.6210,,,AUDJPY
1713,2009.03.02 02:37,buy,893,0.01,61.6290,,,AUDJPY
1714,2009.03.02 02:37,buy,894,0.01,1.28094,,,AUDNZD
1715,2009.03.02 02:37,buy,895,0.01,1.28103,,,AUDNZD
1716,2009.03.02 02:37,buy,896,0.01,0.63309,,,AUDUSD
1717,2009.03.02 02:37,buy,897,0.01,0.63308,,,AUDUSD
1718,2009.03.03 04:12,close,885,0.01,1.98649,2.22,12869.18,EURAUD
1719,2009.03.03 04:12,close,884,0.01,1.98649,2.25,12871.43,EURAUD
1720,2009.03.03 04:12,close,871,0.01,1.98649,-2.51,12868.92,EURAUD
1721,2009.03.03 04:12,close,870,0.01,1.98649,-2.60,12866.32,EURAUD
1722,2009.03.03 04:12,close,862,0.01,1.98649,-9.32,12857.00,EURAUD
1723,2009.03.03 04:12,close,856,0.01,1.98649,-10.45,12846.55,EURAUD
1724,2009.03.03 04:12,close,843,0.01,1.98649,-10.66,12835.89,EURAUD
1725,2009.03.03 04:12,close,842,0.01,1.98649,-10.64,12825.25,EURAUD
1726,2009.03.03 04:12,close,835,0.01,1.98649,-16.36,12808.89,EURAUD
1727,2009.03.03 04:12,close,828,0.01,1.98649,-16.76,12792.13,EURAUD
1728,2009.03.03 04:12,close,824,0.01,1.98649,-18.88,12773.25,EURAUD
1729,2009.03.03 04:17,close,891,0.01,0.74455,2.24,12775.49,AUDCHF
1730,2009.03.03 04:17,close,890,0.01,0.74455,2.35,12777.84,AUDCHF
1731,2009.03.03 04:17,close,878,0.01,0.74455,-0.21,12777.63,AUDCHF
1732,2009.03.03 04:17,close,877,0.01,0.74455,-0.14,12777.49,AUDCHF
1733,2009.03.03 04:17,close,865,0.01,0.74455,-2.01,12775.48,AUDCHF
1734,2009.03.03 04:17,close,858,0.01,0.74455,-3.42,12772.06,AUDCHF
1735,2009.03.03 04:17,close,847,0.01,0.74455,-3.46,12768.60,AUDCHF
1736,2009.03.03 04:17,close,846,0.01,0.74455,-3.48,12765.12,AUDCHF
1737,2009.03.03 04:17,close,838,0.01,0.74455,-9.79,12755.33,AUDCHF
1738,2009.03.03 04:17,close,832,0.01,0.74455,-8.23,12747.10,AUDCHF
1739,2009.03.03 04:17,close,826,0.01,0.74455,-9.89,12737.21,AUDCHF
1740,2009.03.03 04:17,close,893,0.01,61.6870,0.66,12737.87,AUDJPY
1741,2009.03.03 04:17,close,892,0.01,61.6870,0.74,12738.61,AUDJPY
1742,2009.03.03 04:17,close,879,0.01,61.6870,0.66,12739.27,AUDJPY
1743,2009.03.03 04:17,close,872,0.01,61.6870,0.59,12739.86,AUDJPY
1744,2009.03.03 04:17,close,866,0.01,61.6870,-7.03,12732.83,AUDJPY
1745,2009.03.03 04:17,close,859,0.01,61.6870,-9.24,12723.59,AUDJPY
1746,2009.03.03 04:17,close,849,0.01,61.6870,-8.71,12714.88,AUDJPY
1747,2009.03.03 04:17,close,848,0.01,61.6870,-8.72,12706.16,AUDJPY
1748,2009.03.03 04:17,close,839,0.01,61.6870,-10.63,12695.53,AUDJPY
1749,2009.03.03 04:17,close,830,0.01,61.6870,-14.04,12681.49,AUDJPY
1750,2009.03.03 04:17,close,821,0.01,61.6870,-20.03,12661.46,AUDJPY
1751,2009.03.03 04:17,close,895,0.01,1.28135,0.27,12661.73,AUDNZD
1752,2009.03.03 04:17,close,894,0.01,1.28135,0.35,12662.08,AUDNZD
1753,2009.03.03 04:17,close,881,0.01,1.28135,2.05,12664.13,AUDNZD
1754,2009.03.03 04:17,close,880,0.01,1.28135,2.12,12666.25,AUDNZD
1755,2009.03.03 04:17,close,867,0.01,1.28135,7.90,12674.15,AUDNZD
1756,2009.03.03 04:17,close,860,0.01,1.28135,8.40,12682.55,AUDNZD
1757,2009.03.03 04:17,close,851,0.01,1.28135,7.67,12690.22,AUDNZD
1758,2009.03.03 04:17,close,850,0.01,1.28135,7.64,12697.86,AUDNZD
1759,2009.03.03 04:17,close,840,0.01,1.28135,6.54,12704.40,AUDNZD
1760,2009.03.03 04:17,close,833,0.01,1.28135,4.14,12708.54,AUDNZD
1761,2009.03.03 04:17,close,823,0.01,1.28135,5.14,12713.68,AUDNZD
1762,2009.03.03 04:17,close,897,0.01,0.63412,1.11,12714.79,AUDUSD
1763,2009.03.03 04:17,close,896,0.01,0.63412,1.10,12715.89,AUDUSD
1764,2009.03.03 04:17,close,883,0.01,0.63412,-0.10,12715.79,AUDUSD
1765,2009.03.03 04:17,close,882,0.01,0.63412,-0.05,12715.74,AUDUSD
1766,2009.03.03 04:17,close,868,0.01,0.63412,-3.64,12712.10,AUDUSD
1767,2009.03.03 04:17,close,861,0.01,0.63412,-5.23,12706.87,AUDUSD
1768,2009.03.03 04:17,close,855,0.01,0.63412,-5.41,12701.46,AUDUSD
1769,2009.03.03 04:17,close,854,0.01,0.63412,-5.48,12695.98,AUDUSD
1770,2009.03.03 04:17,close,841,0.01,0.63412,-8.86,12687.12,AUDUSD
1771,2009.03.03 04:17,close,834,0.01,0.63412,-11.21,12675.91,AUDUSD
1772,2009.03.03 04:17,close,827,0.01,0.63412,-13.31,12662.60,AUDUSD
1773,2009.03.03 04:17,close,887,0.01,2.21533,35.73,12698.33,GBPAUD
1774,2009.03.03 04:17,close,886,0.01,2.21533,35.71,12734.04,GBPAUD
1775,2009.03.03 04:17,close,874,0.01,2.21533,28.90,12762.94,GBPAUD
1776,2009.03.03 04:17,close,873,0.01,2.21533,28.87,12791.81,GBPAUD
1777,2009.03.03 04:17,close,869,0.01,2.21533,10.08,12801.89,GBPAUD
1778,2009.03.03 04:17,close,863,0.01,2.21533,7.63,12809.52,GBPAUD
1779,2009.03.03 04:17,close,853,0.01,2.21533,0.19,12809.71,GBPAUD
1780,2009.03.03 04:17,close,852,0.01,2.21533,0.08,12809.79,GBPAUD
1781,2009.03.03 04:17,close,836,0.01,2.21533,-6.81,12802.98,GBPAUD
1782,2009.03.03 04:17,close,831,0.01,2.21533,-3.58,12799.40,GBPAUD
1783,2009.03.03 04:17,close,825,0.01,2.21533,-6.56,12792.84,GBPAUD
1784,2009.03.03 04:18,close,889,0.01,0.81690,7.58,12800.42,AUDCAD
1785,2009.03.03 04:18,close,888,0.01,0.81690,7.56,12807.98,AUDCAD
1786,2009.03.03 04:18,close,876,0.01,0.81690,5.12,12813.10,AUDCAD
1787,2009.03.03 04:18,close,875,0.01,0.81690,5.27,12818.37,AUDCAD
1788,2009.03.03 04:18,close,864,0.01,0.81690,8.65,12827.02,AUDCAD
1789,2009.03.03 04:18,close,857,0.01,0.81690,6.96,12833.98,AUDCAD
1790,2009.03.03 04:18,close,845,0.01,0.81690,6.11,12840.09,AUDCAD
1791,2009.03.03 04:18,close,844,0.01,0.81690,6.09,12846.18,AUDCAD
1792,2009.03.03 04:18,close,837,0.01,0.81690,8.95,12855.13,AUDCAD
1793,2009.03.03 04:18,close,829,0.01,0.81690,7.23,12862.36,AUDCAD
1794,2009.03.03 04:18,close,822,0.01,0.81690,5.83,12868.19,AUDCAD
1795,2009.03.04 03:55,sell,898,0.01,1.97150,,,EURAUD
1796,2009.03.04 03:58,buy,899,0.01,0.74823,,,AUDCHF
1797,2009.03.04 03:58,buy,900,0.01,1.28053,,,AUDNZD
1798,2009.03.04 03:58,sell,901,0.01,2.21211,,,GBPAUD
1799,2009.03.04 03:59,buy,902,0.01,0.82048,,,AUDCAD
1800,2009.03.04 03:59,buy,903,0.01,62.3900,,,AUDJPY
1801,2009.03.04 04:00,buy,904,0.01,0.63379,,,AUDUSD
1802,2009.03.04 04:05,sell,905,0.01,1.97320,,,EURAUD
1803,2009.03.04 04:10,buy,906,0.01,0.81946,,,AUDCAD
1804,2009.03.04 04:10,buy,907,0.01,0.74722,,,AUDCHF
1805,2009.03.04 04:10,buy,908,0.01,62.2910,,,AUDJPY
1806,2009.03.04 04:10,buy,909,0.01,1.28035,,,AUDNZD
1807,2009.03.04 04:10,buy,910,0.01,0.63293,,,AUDUSD
1808,2009.03.04 04:10,sell,911,0.01,2.21457,,,GBPAUD
1809,2009.03.04 04:11,sell,912,0.01,1.97364,,,EURAUD
1810,2009.03.04 04:16,buy,913,0.01,0.81774,,,AUDCAD
1811,2009.03.04 04:16,buy,914,0.01,0.74661,,,AUDCHF
1812,2009.03.04 04:16,buy,915,0.01,62.2030,,,AUDJPY
1813,2009.03.04 04:16,buy,916,0.01,1.27896,,,AUDNZD
1814,2009.03.04 04:16,buy,917,0.01,0.63174,,,AUDUSD
1815,2009.03.04 04:16,sell,918,0.01,2.21754,,,GBPAUD
1816,2009.03.04 11:55,close,918,0.01,2.20514,12.78,12880.97,GBPAUD
1817,2009.03.04 11:55,close,911,0.01,2.20514,9.72,12890.69,GBPAUD
1818,2009.03.04 11:55,close,901,0.01,2.20514,7.18,12897.87,GBPAUD
1819,2009.03.04 11:57,close,912,0.01,1.95972,14.35,12912.22,EURAUD
1820,2009.03.04 11:57,close,905,0.01,1.95972,13.90,12926.12,EURAUD
1821,2009.03.04 11:57,close,898,0.01,1.95972,12.14,12938.26,EURAUD
1822,2009.03.04 11:59,close,913,0.01,0.82559,7.78,12946.04,AUDCAD
1823,2009.03.04 11:59,close,906,0.01,0.82559,6.07,12952.11,AUDCAD
1824,2009.03.04 11:59,close,902,0.01,0.82559,5.06,12957.17,AUDCAD
1825,2009.03.04 11:59,close,914,0.01,0.75415,8.07,12965.24,AUDCHF
1826,2009.03.04 11:59,close,907,0.01,0.75415,7.41,12972.65,AUDCHF
1827,2009.03.04 11:59,close,899,0.01,0.75415,6.33,12978.98,AUDCHF
1828,2009.03.04 11:59,close,915,0.01,63.3910,11.98,12990.96,AUDJPY
1829,2009.03.04 11:59,close,908,0.01,63.3910,11.09,13002.05,AUDJPY
1830,2009.03.04 11:59,close,903,0.01,63.3910,10.09,13012.14,AUDJPY
1831,2009.03.04 11:59,close,916,0.01,1.27875,-0.18,13011.96,AUDNZD
1832,2009.03.04 11:59,close,909,0.01,1.27875,-1.37,13010.59,AUDNZD
1833,2009.03.04 11:59,close,900,0.01,1.27875,-1.52,13009.07,AUDNZD
1834,2009.03.04 12:00,close,917,0.01,0.63816,6.42,13015.49,AUDUSD
1835,2009.03.04 12:00,close,910,0.01,0.63816,5.23,13020.72,AUDUSD
1836,2009.03.04 12:00,close,904,0.01,0.63816,4.37,13025.09,AUDUSD
1837,2009.03.05 04:25,sell,919,0.01,1.95912,,,EURAUD
1838,2009.03.05 04:28,buy,920,0.01,0.75472,,,AUDCHF
1839,2009.03.05 04:28,sell,921,0.01,2.19722,,,GBPAUD
1840,2009.03.05 04:29,buy,922,0.01,0.82304,,,AUDCAD
1841,2009.03.05 04:29,buy,923,0.01,63.9500,,,AUDJPY
1842,2009.03.05 04:29,buy,924,0.01,1.28052,,,AUDNZD
1843,2009.03.05 04:30,buy,925,0.01,0.64423,,,AUDUSD
1844,2009.03.05 04:31,sell,926,0.01,1.95997,,,EURAUD
1845,2009.03.05 04:36,buy,927,0.01,0.82138,,,AUDCAD
1846,2009.03.05 04:36,buy,928,0.01,0.75387,,,AUDCHF
1847,2009.03.05 04:36,buy,929,0.01,63.7800,,,AUDJPY
1848,2009.03.05 04:36,buy,930,0.01,1.28004,,,AUDNZD
1849,2009.03.05 04:36,buy,931,0.01,0.64277,,,AUDUSD
1850,2009.03.05 04:36,sell,932,0.01,2.20003,,,GBPAUD
1851,2009.03.05 13:55,sell,933,0.01,2.20036,,,GBPAUD
1852,2009.03.05 13:58,sell,934,0.01,1.96202,,,EURAUD
1853,2009.03.05 14:00,buy,935,0.01,0.82175,,,AUDCAD
1854,2009.03.05 14:00,buy,936,0.01,0.75196,,,AUDCHF
1855,2009.03.05 14:00,buy,937,0.01,63.5560,,,AUDJPY
1856,2009.03.05 14:00,buy,938,0.01,1.27973,,,AUDNZD
1857,2009.03.05 14:00,buy,939,0.01,0.64028,,,AUDUSD
1858,2009.03.05 22:25,sell,940,0.01,1.96734,,,EURAUD
1859,2009.03.05 22:25,sell,941,0.01,1.96730,,,EURAUD
1860,2009.03.05 22:25,sell,942,0.01,1.96734,,,EURAUD
1861,2009.03.05 22:26,buy,943,0.01,62.5360,,,AUDJPY
1862,2009.03.05 22:26,buy,944,0.01,62.5300,,,AUDJPY
1863,2009.03.05 22:26,buy,945,0.01,62.5330,,,AUDJPY
1864,2009.03.05 22:29,buy,946,0.01,0.82255,,,AUDCAD
1865,2009.03.05 22:29,buy,947,0.01,0.82258,,,AUDCAD
1866,2009.03.05 22:29,buy,948,0.01,0.82257,,,AUDCAD
1867,2009.03.05 22:29,buy,949,0.01,0.74670,,,AUDCHF
1868,2009.03.05 22:29,buy,950,0.01,0.74677,,,AUDCHF
1869,2009.03.05 22:29,buy,951,0.01,0.74681,,,AUDCHF
1870,2009.03.05 22:29,buy,952,0.01,1.27738,,,AUDNZD
1871,2009.03.05 22:29,buy,953,0.01,1.27731,,,AUDNZD
1872,2009.03.05 22:29,buy,954,0.01,1.27774,,,AUDNZD
1873,2009.03.05 22:29,sell,955,0.01,2.21269,,,GBPAUD
1874,2009.03.05 22:29,sell,956,0.01,2.21328,,,GBPAUD
1875,2009.03.05 22:29,sell,957,0.01,2.21297,,,GBPAUD
1876,2009.03.05 22:30,buy,958,0.01,0.63843,,,AUDUSD
1877,2009.03.05 22:30,buy,959,0.01,0.63833,,,AUDUSD
1878,2009.03.05 22:30,buy,960,0.01,0.63836,,,AUDUSD
1879,2009.03.06 12:55,sell,961,0.01,1.97850,,,EURAUD
1880,2009.03.06 12:55,sell,962,0.01,1.97854,,,EURAUD
1881,2009.03.06 12:59,buy,963,0.01,0.82410,,,AUDCAD
1882,2009.03.06 12:59,buy,964,0.01,0.82402,,,AUDCAD
1883,2009.03.06 12:59,buy,965,0.01,0.74120,,,AUDCHF
1884,2009.03.06 12:59,sell,966,0.01,2.22025,,,GBPAUD
1885,2009.03.06 12:59,sell,967,0.01,2.22028,,,GBPAUD
1886,2009.03.06 13:00,buy,968,0.01,0.74121,,,AUDCHF
1887,2009.03.06 13:00,buy,969,0.01,62.2670,,,AUDJPY
1888,2009.03.06 13:00,buy,970,0.01,62.2650,,,AUDJPY
1889,2009.03.06 13:00,buy,971,0.01,1.27311,,,AUDNZD
1890,2009.03.06 13:00,buy,972,0.01,1.27261,,,AUDNZD
1891,2009.03.06 13:00,buy,973,0.01,0.64101,,,AUDUSD
1892,2009.03.06 13:00,buy,974,0.01,0.64104,,,AUDUSD
1893,2009.03.06 13:03,sell,975,0.01,1.97712,,,EURAUD
1894,2009.03.06 13:08,buy,976,0.01,0.82217,,,AUDCAD
1895,2009.03.06 13:08,buy,977,0.01,0.73985,,,AUDCHF
1896,2009.03.06 13:08,buy,978,0.01,62.2310,,,AUDJPY
1897,2009.03.06 13:08,buy,979,0.01,1.27241,,,AUDNZD
1898,2009.03.06 13:08,buy,980,0.01,0.64036,,,AUDUSD
1899,2009.03.06 13:08,sell,981,0.01,2.22267,,,GBPAUD
1900,2009.03.10 03:55,close,975,0.01,1.98651,-9.48,13015.61,EURAUD
1901,2009.03.10 03:55,close,962,0.01,1.98651,-8.02,13007.59,EURAUD
1902,2009.03.10 03:55,close,961,0.01,1.98651,-8.06,12999.53,EURAUD
1903,2009.03.10 03:55,close,942,0.01,1.98651,-19.48,12980.05,EURAUD
1904,2009.03.10 03:55,close,941,0.01,1.98651,-19.52,12960.53,EURAUD
1905,2009.03.10 03:55,close,940,0.01,1.98651,-19.48,12941.05,EURAUD
1906,2009.03.10 03:55,close,934,0.01,1.98651,-24.96,12916.09,EURAUD
1907,2009.03.10 03:55,close,926,0.01,1.98651,-27.08,12889.01,EURAUD
1908,2009.03.10 03:55,close,919,0.01,1.98651,-27.95,12861.06,EURAUD
1909,2009.03.10 03:59,close,976,0.01,0.82493,2.83,12863.89,AUDCAD
1910,2009.03.10 03:59,close,964,0.01,0.82493,0.99,12864.88,AUDCAD
1911,2009.03.10 03:59,close,963,0.01,0.82493,0.91,12865.79,AUDCAD
1912,2009.03.10 03:59,close,948,0.01,0.82493,2.47,12868.26,AUDCAD
1913,2009.03.10 03:59,close,947,0.01,0.82493,2.46,12870.72,AUDCAD
1914,2009.03.10 03:59,close,946,0.01,0.82493,2.49,12873.21,AUDCAD
1915,2009.03.10 03:59,close,935,0.01,0.82493,3.28,12876.49,AUDCAD
1916,2009.03.10 03:59,close,927,0.01,0.82493,3.65,12880.14,AUDCAD
1917,2009.03.10 03:59,close,922,0.01,0.82493,2.00,12882.14,AUDCAD
1918,2009.03.10 03:59,close,977,0.01,0.73633,-3.63,12878.51,AUDCHF
1919,2009.03.10 03:59,close,968,0.01,0.73633,-5.08,12873.43,AUDCHF
1920,2009.03.10 03:59,close,965,0.01,0.73633,-5.07,12868.36,AUDCHF
1921,2009.03.10 03:59,close,951,0.01,0.73633,-11.01,12857.35,AUDCHF
1922,2009.03.10 03:59,close,950,0.01,0.73633,-10.97,12846.38,AUDCHF
1923,2009.03.10 03:59,close,949,0.01,0.73633,-10.89,12835.49,AUDCHF
1924,2009.03.10 03:59,close,936,0.01,0.73633,-16.51,12818.98,AUDCHF
1925,2009.03.10 03:59,close,928,0.01,0.73633,-18.56,12800.42,AUDCHF
1926,2009.03.10 03:59,close,920,0.01,0.73633,-19.46,12780.96,AUDCHF
1927,2009.03.10 03:59,close,978,0.01,62.9710,7.61,12788.57,AUDJPY
1928,2009.03.10 03:59,close,970,0.01,62.9710,7.27,12795.84,AUDJPY
1929,2009.03.10 03:59,close,969,0.01,62.9710,7.24,12803.08,AUDJPY
1930,2009.03.10 03:59,close,945,0.01,62.9710,4.63,12807.71,AUDJPY
1931,2009.03.10 03:59,close,944,0.01,62.9710,4.66,12812.37,AUDJPY
1932,2009.03.10 03:59,close,943,0.01,62.9710,4.60,12816.97,AUDJPY
1933,2009.03.10 03:59,close,937,0.01,62.9710,-5.68,12811.29,AUDJPY
1934,2009.03.10 03:59,close,929,0.01,62.9710,-7.94,12803.35,AUDJPY
1935,2009.03.10 03:59,close,923,0.01,62.9710,-9.66,12793.69,AUDJPY
1936,2009.03.10 03:59,close,979,0.01,1.28219,8.34,12802.03,AUDNZD
1937,2009.03.10 03:59,close,972,0.01,1.28219,8.17,12810.20,AUDNZD
1938,2009.03.10 03:59,close,971,0.01,1.28219,7.74,12817.94,AUDNZD
1939,2009.03.10 03:59,close,954,0.01,1.28219,3.79,12821.73,AUDNZD
1940,2009.03.10 03:59,close,953,0.01,1.28219,4.16,12825.89,AUDNZD
1941,2009.03.10 03:59,close,952,0.01,1.28219,4.10,12829.99,AUDNZD
1942,2009.03.10 03:59,close,938,0.01,1.28219,2.09,12832.08,AUDNZD
1943,2009.03.10 03:59,close,930,0.01,1.28219,1.82,12833.90,AUDNZD
1944,2009.03.10 03:59,close,924,0.01,1.28219,1.41,12835.31,AUDNZD
1945,2009.03.10 03:59,close,981,0.01,2.17023,54.27,12889.58,GBPAUD
1946,2009.03.10 03:59,close,967,0.01,2.17023,51.81,12941.39,GBPAUD
1947,2009.03.10 03:59,close,966,0.01,2.17023,51.78,12993.17,GBPAUD
1948,2009.03.10 03:59,close,957,0.01,2.17023,44.37,13037.54,GBPAUD
1949,2009.03.10 03:59,close,956,0.01,2.17023,44.69,13082.23,GBPAUD
1950,2009.03.10 03:59,close,955,0.01,2.17023,44.08,13126.31,GBPAUD
1951,2009.03.10 03:59,close,933,0.01,2.17023,31.37,13157.68,GBPAUD
1952,2009.03.10 03:59,close,932,0.01,2.17023,31.03,13188.71,GBPAUD
1953,2009.03.10 03:59,close,921,0.01,2.17023,28.13,13216.84,GBPAUD
1954,2009.03.10 04:00,close,980,0.01,0.63674,-3.49,13213.35,AUDUSD
1955,2009.03.10 04:00,close,974,0.01,0.63674,-4.17,13209.18,AUDUSD
1956,2009.03.10 04:00,close,973,0.01,0.63674,-4.14,13205.04,AUDUSD
1957,2009.03.10 04:00,close,960,0.01,0.63674,-1.43,13203.61,AUDUSD
1958,2009.03.10 04:00,close,959,0.01,0.63674,-1.40,13202.21,AUDUSD
1959,2009.03.10 04:00,close,958,0.01,0.63674,-1.49,13200.72,AUDUSD
1960,2009.03.10 04:00,close,939,0.01,0.63674,-3.35,13197.37,AUDUSD
1961,2009.03.10 04:00,close,931,0.01,0.63674,-5.84,13191.53,AUDUSD
1962,2009.03.10 04:00,close,925,0.01,0.63674,-7.29,13184.24,AUDUSD
1963,2009.03.12 06:06,sell,982,0.01,1.98029,,,EURAUD
1964,2009.03.12 06:09,buy,983,0.01,62.3980,,,AUDJPY
1965,2009.03.12 06:10,buy,984,0.01,0.74688,,,AUDCHF
1966,2009.03.12 06:10,sell,985,0.01,2.13830,,,GBPAUD
1967,2009.03.12 06:11,buy,986,0.01,0.83543,,,AUDCAD
1968,2009.03.12 06:11,buy,987,0.01,1.26405,,,AUDNZD
1969,2009.03.12 06:11,buy,988,0.01,0.64859,,,AUDUSD
1970,2009.03.12 10:55,sell,989,0.01,1.98012,,,EURAUD
1971,2009.03.12 10:59,buy,990,0.01,62.1060,,,AUDJPY
1972,2009.03.12 10:59,buy,991,0.01,1.26139,,,AUDNZD
1973,2009.03.12 10:59,sell,992,0.01,2.13538,,,GBPAUD
1974,2009.03.12 11:00,buy,993,0.01,0.83209,,,AUDCAD
1975,2009.03.12 11:00,buy,994,0.01,0.74652,,,AUDCHF
1976,2009.03.12 11:00,buy,995,0.01,0.64600,,,AUDUSD
1977,2009.03.12 11:08,sell,996,0.01,1.97974,,,EURAUD
1978,2009.03.12 11:11,sell,997,0.01,2.13590,,,GBPAUD
1979,2009.03.12 11:13,buy,998,0.01,0.82947,,,AUDCAD
1980,2009.03.12 11:13,buy,999,0.01,0.74533,,,AUDCHF
1981,2009.03.12 11:13,buy,1000,0.01,61.9200,,,AUDJPY
1982,2009.03.12 11:13,buy,1001,0.01,1.26021,,,AUDNZD
1983,2009.03.12 11:13,buy,1002,0.01,0.64457,,,AUDUSD
1984,2009.03.12 19:55,close,996,0.01,1.97277,7.19,13191.43,EURAUD
1985,2009.03.12 19:55,close,989,0.01,1.97277,7.58,13199.01,EURAUD
1986,2009.03.12 19:55,close,982,0.01,1.97277,7.76,13206.77,EURAUD
1987,2009.03.12 20:00,close,998,0.01,0.83407,4.56,13211.33,AUDCAD
1988,2009.03.12 20:00,close,993,0.01,0.83407,1.96,13213.29,AUDCAD
1989,2009.03.12 20:00,close,986,0.01,0.83407,-1.35,13211.94,AUDCAD
1990,2009.03.12 20:00,close,999,0.01,0.77471,31.40,13243.34,AUDCHF
1991,2009.03.12 20:00,close,994,0.01,0.77471,30.13,13273.47,AUDCHF
1992,2009.03.12 20:00,close,984,0.01,0.77471,29.75,13303.22,AUDCHF
1993,2009.03.12 20:00,close,1000,0.01,63.9330,20.29,13323.51,AUDJPY
1994,2009.03.12 20:00,close,990,0.01,63.9330,18.42,13341.93,AUDJPY
1995,2009.03.12 20:00,close,983,0.01,63.9330,15.47,13357.40,AUDJPY
1996,2009.03.12 20:00,close,1001,0.01,1.25149,-7.44,13349.96,AUDNZD
1997,2009.03.12 20:00,close,991,0.01,1.25149,-8.45,13341.51,AUDNZD
1998,2009.03.12 20:00,close,987,0.01,1.25149,-10.72,13330.79,AUDNZD
1999,2009.03.12 20:00,close,1002,0.01,0.65232,7.75,13338.54,AUDUSD
2000,2009.03.12 20:00,close,995,0.01,0.65232,6.32,13344.86,AUDUSD
2001,2009.03.12 20:00,close,988,0.01,0.65232,3.73,13348.59,AUDUSD
2002,2009.03.12 20:00,close,997,0.01,2.13103,5.02,13353.61,GBPAUD
2003,2009.03.12 20:00,close,992,0.01,2.13103,4.48,13358.09,GBPAUD
2004,2009.03.12 20:00,close,985,0.01,2.13103,7.50,13365.59,GBPAUD
2005,2009.03.17 10:25,sell,1003,0.01,1.97305,,,EURAUD
2006,2009.03.17 10:28,sell,1004,0.01,2.13324,,,GBPAUD
2007,2009.03.17 10:29,buy,1005,0.01,64.8280,,,AUDJPY
2008,2009.03.17 10:30,buy,1006,0.01,0.83687,,,AUDCAD
2009,2009.03.17 10:30,buy,1007,0.01,0.77981,,,AUDCHF
2010,2009.03.17 10:30,buy,1008,0.01,1.24308,,,AUDNZD
2011,2009.03.17 10:30,buy,1009,0.01,0.65788,,,AUDUSD
2012,2009.03.18 18:08,sell,1010,0.01,1.98798,,,EURAUD
2013,2009.03.18 18:12,sell,1011,0.01,2.12026,,,GBPAUD
2014,2009.03.18 18:13,buy,1012,0.01,0.83969,,,AUDCAD
2015,2009.03.18 18:13,buy,1013,0.01,0.76908,,,AUDCHF
2016,2009.03.18 18:13,buy,1014,0.01,64.5660,,,AUDJPY
2017,2009.03.18 18:13,buy,1015,0.01,1.24620,,,AUDNZD
2018,2009.03.18 18:13,buy,1016,0.01,0.65992,,,AUDUSD
2019,2009.03.19 11:56,close,1011,0.01,2.10185,19.28,13384.87,GBPAUD
2020,2009.03.19 11:56,close,1004,0.01,2.10185,32.77,13417.64,GBPAUD
2021,2009.03.19 12:01,close,1012,0.01,0.84390,4.31,13421.95,AUDCAD
2022,2009.03.19 12:01,close,1006,0.01,0.84390,7.14,13429.09,AUDCAD
2023,2009.03.19 12:01,close,1013,0.01,0.77570,7.26,13436.35,AUDCHF
2024,2009.03.19 12:01,close,1007,0.01,0.77570,-4.14,13432.21,AUDCHF
2025,2009.03.19 12:01,close,1014,0.01,65.0960,5.56,13437.77,AUDJPY
2026,2009.03.19 12:01,close,1005,0.01,65.0960,2.99,13440.76,AUDJPY
2027,2009.03.19 12:01,close,1015,0.01,1.24555,-0.56,13440.20,AUDNZD
2028,2009.03.19 12:01,close,1008,0.01,1.24555,2.10,13442.30,AUDNZD
2029,2009.03.19 12:01,close,1016,0.01,0.68122,21.50,13463.80,AUDUSD
2030,2009.03.19 12:01,close,1009,0.01,0.68122,23.60,13487.40,AUDUSD
2031,2009.03.19 12:01,close,1010,0.01,1.98147,7.01,13494.41,EURAUD
2032,2009.03.19 12:01,close,1003,0.01,1.98147,-8.29,13486.12,EURAUD
2033,2009.03.24 13:25,sell,1017,0.01,1.93698,,,EURAUD
2034,2009.03.24 13:25,sell,1018,0.01,2.10601,,,GBPAUD
2035,2009.03.24 13:29,buy,1019,0.01,68.7500,,,AUDJPY
2036,2009.03.24 13:30,buy,1020,0.01,0.85804,,,AUDCAD
2037,2009.03.24 13:30,buy,1021,0.01,0.78843,,,AUDCHF
2038,2009.03.24 13:30,buy,1022,0.01,1.23452,,,AUDNZD
2039,2009.03.24 13:30,buy,1023,0.01,0.69988,,,AUDUSD
2040,2009.03.24 21:56,sell,1024,0.01,1.93586,,,EURAUD
2041,2009.03.24 21:59,buy,1025,0.01,0.78706,,,AUDCHF
2042,2009.03.24 22:00,buy,1026,0.01,68.0760,,,AUDJPY
2043,2009.03.24 22:00,sell,1027,0.01,2.11000,,,GBPAUD
2044,2009.03.24 22:01,buy,1028,0.01,0.85691,,,AUDCAD
2045,2009.03.24 22:01,buy,1029,0.01,1.23446,,,AUDNZD
2046,2009.03.24 22:01,buy,1030,0.01,0.69548,,,AUDUSD
2047,2009.03.24 22:12,sell,1031,0.01,1.93690,,,EURAUD
2048,2009.03.24 22:13,buy,1032,0.01,67.9690,,,AUDJPY
2049,2009.03.24 22:15,buy,1033,0.01,0.85571,,,AUDCAD
2050,2009.03.24 22:16,sell,1034,0.01,2.11120,,,GBPAUD
2051,2009.03.24 22:17,buy,1035,0.01,0.78640,,,AUDCHF
2052,2009.03.24 22:17,buy,1036,0.01,1.23556,,,AUDNZD
2053,2009.03.24 22:17,buy,1037,0.01,0.69468,,,AUDUSD
2054,2009.03.26 12:25,close,1034,0.01,2.07330,39.48,13525.60,GBPAUD
2055,2009.03.26 12:25,close,1027,0.01,2.07330,38.24,13563.84,GBPAUD
2056,2009.03.26 12:25,close,1018,0.01,2.07330,34.13,13597.97,GBPAUD
2057,2009.03.26 12:28,close,1031,0.01,1.93340,4.00,13601.97,EURAUD
2058,2009.03.26 12:28,close,1024,0.01,1.93340,2.92,13604.89,EURAUD
2059,2009.03.26 12:28,close,1017,0.01,1.93340,4.08,13608.97,EURAUD
2060,2009.03.26 12:29,close,1035,0.01,0.79015,4.27,13613.24,AUDCHF
2061,2009.03.26 12:29,close,1025,0.01,0.79015,3.56,13616.80,AUDCHF
2062,2009.03.26 12:29,close,1021,0.01,0.79015,2.10,13618.90,AUDCHF
2063,2009.03.26 12:29,close,1036,0.01,1.21539,-17.23,13601.67,AUDNZD
2064,2009.03.26 12:29,close,1029,0.01,1.21539,-16.29,13585.38,AUDNZD
2065,2009.03.26 12:29,close,1022,0.01,1.21539,-16.34,13569.04,AUDNZD
2066,2009.03.26 12:30,close,1033,0.01,0.86185,6.25,13575.29,AUDCAD
2067,2009.03.26 12:30,close,1028,0.01,0.86185,5.06,13580.35,AUDCAD
2068,2009.03.26 12:30,close,1020,0.01,0.86185,3.94,13584.29,AUDCAD
2069,2009.03.26 12:30,close,1032,0.01,69.0410,11.10,13595.39,AUDJPY
2070,2009.03.26 12:30,close,1026,0.01,69.0410,10.02,13605.41,AUDJPY
2071,2009.03.26 12:30,close,1019,0.01,69.0410,3.22,13608.63,AUDJPY
2072,2009.03.26 12:30,close,1037,0.01,0.70232,7.90,13616.53,AUDUSD
2073,2009.03.26 12:30,close,1030,0.01,0.70232,7.10,13623.63,AUDUSD
2074,2009.03.26 12:30,close,1023,0.01,0.70232,2.70,13626.33,AUDUSD
2075,2009.03.27 04:51,sell,1038,0.01,1.93628,,,EURAUD
2076,2009.03.27 04:55,sell,1039,0.01,2.06583,,,GBPAUD
2077,2009.03.27 04:56,buy,1040,0.01,0.85988,,,AUDCAD
2078,2009.03.27 04:56,buy,1041,0.01,0.78743,,,AUDCHF
2079,2009.03.27 04:56,buy,1042,0.01,68.8630,,,AUDJPY
2080,2009.03.27 04:56,buy,1043,0.01,1.21564,,,AUDNZD
2081,2009.03.27 04:56,buy,1044,0.01,0.70066,,,AUDUSD
2082,2009.03.27 06:55,sell,1045,0.01,2.07041,,,GBPAUD
2083,2009.03.27 06:58,sell,1046,0.01,1.94049,,,EURAUD
2084,2009.03.27 06:59,buy,1047,0.01,68.7290,,,AUDJPY
2085,2009.03.27 07:00,buy,1048,0.01,0.85810,,,AUDCAD
2086,2009.03.27 07:00,buy,1049,0.01,0.78604,,,AUDCHF
2087,2009.03.27 07:00,buy,1050,0.01,1.21546,,,AUDNZD
2088,2009.03.27 07:00,buy,1051,0.01,0.69956,,,AUDUSD
2089,2009.03.27 15:55,sell,1052,0.01,1.92639,,,EURAUD
2090,2009.03.27 15:59,buy,1053,0.01,1.21313,,,AUDNZD
2091,2009.03.27 16:00,buy,1054,0.01,0.85695,,,AUDCAD
2092,2009.03.27 16:00,buy,1055,0.01,0.79018,,,AUDCHF
2093,2009.03.27 16:00,buy,1056,0.01,67.6880,,,AUDJPY
2094,2009.03.27 16:00,buy,1057,0.01,0.69100,,,AUDUSD
2095,2009.03.27 16:00,sell,1058,0.01,2.07270,,,GBPAUD
2096,2009.03.30 13:25,sell,1059,0.01,1.93751,,,EURAUD
2097,2009.03.30 13:25,sell,1060,0.01,1.93752,,,EURAUD
2098,2009.03.30 13:25,sell,1061,0.01,1.93751,,,EURAUD
2099,2009.03.30 13:25,sell,1062,0.01,1.93753,,,EURAUD
2100,2009.03.30 13:29,sell,1063,0.01,2.08261,,,GBPAUD
2101,2009.03.30 13:30,buy,1064,0.01,0.85058,,,AUDCAD
2102,2009.03.30 13:30,buy,1065,0.01,0.85044,,,AUDCAD
2103,2009.03.30 13:30,buy,1066,0.01,0.85030,,,AUDCAD
2104,2009.03.30 13:30,buy,1067,0.01,0.85031,,,AUDCAD
2105,2009.03.30 13:30,buy,1068,0.01,0.78222,,,AUDCHF
2106,2009.03.30 13:30,buy,1069,0.01,0.78223,,,AUDCHF
2107,2009.03.30 13:30,buy,1070,0.01,0.78224,,,AUDCHF
2108,2009.03.30 13:30,buy,1071,0.01,0.78223,,,AUDCHF
2109,2009.03.30 13:30,buy,1072,0.01,65.8610,,,AUDJPY
2110,2009.03.30 13:30,buy,1073,0.01,65.8620,,,AUDJPY
2111,2009.03.30 13:30,buy,1074,0.01,65.8610,,,AUDJPY
2112,2009.03.30 13:30,buy,1075,0.01,65.8590,,,AUDJPY
2113,2009.03.30 13:30,buy,1076,0.01,1.20903,,,AUDNZD
2114,2009.03.30 13:30,buy,1077,0.01,1.20921,,,AUDNZD
2115,2009.03.30 13:30,buy,1078,0.01,1.20916,,,AUDNZD
2116,2009.03.30 13:30,buy,1079,0.01,1.20921,,,AUDNZD
2117,2009.03.30 13:30,buy,1080,0.03,0.68106,,,AUDUSD
2118,2009.03.30 13:30,buy,1081,0.01,0.68107,,,AUDUSD
2119,2009.03.30 13:30,sell,1082,0.01,2.08252,,,GBPAUD
2120,2009.03.30 13:30,sell,1083,0.01,2.08261,,,GBPAUD
2121,2009.03.30 13:30,sell,1084,0.01,2.08270,,,GBPAUD
2122,2009.03.31 07:25,close,1062,0.01,1.92809,9.83,13636.16,EURAUD
2123,2009.03.31 07:25,close,1061,0.01,1.92809,9.81,13645.97,EURAUD
2124,2009.03.31 07:25,close,1060,0.01,1.92809,9.82,13655.79,EURAUD
2125,2009.03.31 07:25,close,1059,0.01,1.92809,9.81,13665.60,EURAUD
2126,2009.03.31 07:25,close,1052,0.01,1.92809,-1.55,13664.05,EURAUD
2127,2009.03.31 07:25,close,1046,0.01,1.92809,12.98,13677.03,EURAUD
2128,2009.03.31 07:25,close,1038,0.01,1.92809,8.64,13685.67,EURAUD
2129,2009.03.31 07:28,close,1075,0.01,67.2930,14.53,13700.20,AUDJPY
2130,2009.03.31 07:28,close,1074,0.01,67.2930,14.51,13714.71,AUDJPY
2131,2009.03.31 07:28,close,1073,0.01,67.2930,14.50,13729.21,AUDJPY
2132,2009.03.31 07:28,close,1072,0.01,67.2930,14.51,13743.72,AUDJPY
2133,2009.03.31 07:28,close,1056,0.01,67.2930,-3.84,13739.88,AUDJPY
2134,2009.03.31 07:28,close,1047,0.01,67.2930,-14.34,13725.54,AUDJPY
2135,2009.03.31 07:28,close,1042,0.01,67.2930,-15.69,13709.85,AUDJPY
2136,2009.03.31 07:28,close,1084,0.01,2.08120,1.64,13711.49,GBPAUD
2137,2009.03.31 07:28,close,1083,0.01,2.08120,1.55,13713.04,GBPAUD
2138,2009.03.31 07:28,close,1082,0.01,2.08120,1.46,13714.50,GBPAUD
2139,2009.03.31 07:28,close,1063,0.01,2.08120,1.55,13716.05,GBPAUD
2140,2009.03.31 07:28,close,1058,0.01,2.08120,-8.56,13707.49,GBPAUD
2141,2009.03.31 07:28,close,1045,0.01,2.08120,-10.92,13696.57,GBPAUD
2142,2009.03.31 07:28,close,1039,0.01,2.08120,-15.64,13680.93,GBPAUD
2143,2009.03.31 07:29,close,1071,0.01,0.78656,4.69,13685.62,AUDCHF
2144,2009.03.31 07:29,close,1070,0.01,0.78656,4.68,13690.30,AUDCHF
2145,2009.03.31 07:29,close,1069,0.01,0.78656,4.69,13694.99,AUDCHF
2146,2009.03.31 07:29,close,1068,0.01,0.78656,4.70,13699.69,AUDCHF
2147,2009.03.31 07:29,close,1055,0.01,0.78656,-3.74,13695.95,AUDCHF
2148,2009.03.31 07:29,close,1049,0.01,0.78656,0.69,13696.64,AUDCHF
2149,2009.03.31 07:29,close,1041,0.01,0.78656,-0.80,13695.84,AUDCHF
2150,2009.03.31 07:29,close,1079,0.01,1.20683,-2.03,13693.81,AUDNZD
2151,2009.03.31 07:29,close,1078,0.01,1.20683,-1.99,13691.82,AUDNZD
2152,2009.03.31 07:29,close,1077,0.01,1.20683,-2.03,13689.79,AUDNZD
2153,2009.03.31 07:29,close,1076,0.01,1.20683,-1.88,13687.91,AUDNZD
2154,2009.03.31 07:29,close,1053,0.01,1.20683,-5.39,13682.52,AUDNZD
2155,2009.03.31 07:29,close,1050,0.01,1.20683,-7.38,13675.14,AUDNZD
2156,2009.03.31 07:29,close,1043,0.01,1.20683,-7.53,13667.61,AUDNZD
2157,2009.03.31 07:30,close,1067,0.01,0.86380,13.42,13681.03,AUDCAD
2158,2009.03.31 07:30,close,1066,0.01,0.86380,13.43,13694.46,AUDCAD
2159,2009.03.31 07:30,close,1065,0.01,0.86380,13.29,13707.75,AUDCAD
2160,2009.03.31 07:30,close,1064,0.01,0.86380,13.15,13720.90,AUDCAD
2161,2009.03.31 07:30,close,1054,0.01,0.86380,6.88,13727.78,AUDCAD
2162,2009.03.31 07:30,close,1048,0.01,0.86380,5.74,13733.52,AUDCAD
2163,2009.03.31 07:30,close,1040,0.01,0.86380,3.98,13737.50,AUDCAD
2164,2009.03.31 07:30,close,1081,0.01,0.68670,5.70,13743.20,AUDUSD
2165,2009.03.31 07:30,close,1080,0.03,0.68670,17.12,13760.32,AUDUSD
2166,2009.03.31 07:30,close,1057,0.01,0.68670,-4.17,13756.15,AUDUSD
2167,2009.03.31 07:30,close,1051,0.01,0.68670,-12.73,13743.42,AUDUSD
2168,2009.03.31 07:30,close,1044,0.01,0.68670,-13.83,13729.59,AUDUSD
2169,2009.04.03 18:25,sell,1085,0.01,2.08364,,,GBPAUD
2170,2009.04.03 18:29,buy,1086,0.01,0.87612,,,AUDCAD
2171,2009.04.03 18:29,buy,1087,0.01,0.80611,,,AUDCHF
2172,2009.04.03 18:29,buy,1088,0.01,71.1760,,,AUDJPY
2173,2009.04.03 18:29,sell,1089,0.01,1.88891,,,EURAUD
2174,2009.04.03 18:30,buy,1090,0.01,1.22364,,,AUDNZD
2175,2009.04.03 18:30,buy,1091,0.01,0.71174,,,AUDUSD
2176,2009.04.03 18:50,sell,1092,0.01,2.08420,,,GBPAUD
2177,2009.04.03 18:54,buy,1093,0.01,0.87557,,,AUDCAD
2178,2009.04.03 18:54,buy,1094,0.01,71.0080,,,AUDJPY
2179,2009.04.03 18:54,buy,1095,0.01,0.71043,,,AUDUSD
2180,2009.04.03 18:55,buy,1096,0.01,0.80518,,,AUDCHF
2181,2009.04.03 18:55,buy,1097,0.01,1.22281,,,AUDNZD
2182,2009.04.03 18:55,sell,1098,0.01,1.89115,,,EURAUD
2183,2009.04.06 15:00,sell,1099,0.01,1.89327,,,EURAUD
2184,2009.04.06 15:04,sell,1100,0.01,2.08922,,,GBPAUD
2185,2009.04.06 15:05,buy,1101,0.01,0.87889,,,AUDCAD
2186,2009.04.06 15:05,buy,1102,0.01,0.80508,,,AUDCHF
2187,2009.04.06 15:05,buy,1103,0.01,71.6110,,,AUDJPY
2188,2009.04.06 15:05,buy,1104,0.01,1.20877,,,AUDNZD
2189,2009.04.06 15:05,buy,1105,0.01,0.71111,,,AUDUSD
2190,2009.04.06 22:55,close,1100,0.01,2.06767,22.20,13751.79,GBPAUD
2191,2009.04.06 22:55,close,1092,0.01,2.06767,17.13,13768.92,GBPAUD
2192,2009.04.06 22:55,close,1085,0.01,2.06767,16.55,13785.47,GBPAUD
2193,2009.04.06 22:56,close,1099,0.01,1.87951,14.18,13799.65,EURAUD
2194,2009.04.06 22:56,close,1098,0.01,1.87951,12.09,13811.74,EURAUD
2195,2009.04.06 22:56,close,1089,0.01,1.87951,9.78,13821.52,EURAUD
2196,2009.04.06 22:59,close,1103,0.01,72.0580,4.50,13826.02,AUDJPY
2197,2009.04.06 22:59,close,1094,0.01,72.0580,10.66,13836.68,AUDJPY
2198,2009.04.06 22:59,close,1088,0.01,72.0580,8.96,13845.64,AUDJPY
2199,2009.04.06 23:00,close,1101,0.01,0.88352,4.59,13850.23,AUDCAD
2200,2009.04.06 23:00,close,1093,0.01,0.88352,7.93,13858.16,AUDCAD
2201,2009.04.06 23:00,close,1086,0.01,0.88352,7.38,13865.54,AUDCAD
2202,2009.04.06 23:00,close,1102,0.01,0.81074,6.05,13871.59,AUDCHF
2203,2009.04.06 23:00,close,1096,0.01,0.81074,6.01,13877.60,AUDCHF
2204,2009.04.06 23:00,close,1087,0.01,0.81074,5.01,13882.61,AUDCHF
2205,2009.04.06 23:00,close,1104,0.01,1.21194,2.70,13885.31,AUDNZD
2206,2009.04.06 23:00,close,1097,0.01,1.21194,-9.28,13876.03,AUDNZD
2207,2009.04.06 23:00,close,1090,0.01,1.21194,-9.99,13866.04,AUDNZD
2208,2009.04.06 23:00,close,1105,0.01,0.71367,2.56,13868.60,AUDUSD
2209,2009.04.06 23:00,close,1095,0.01,0.71367,3.31,13871.91,AUDUSD
2210,2009.04.06 23:00,close,1091,0.01,0.71367,1.99,13873.90,AUDUSD
2211,2009.04.08 08:55,sell,1106,0.01,2.08037,,,GBPAUD
2212,2009.04.08 08:59,buy,1107,0.01,0.87596,,,AUDCAD
2213,2009.04.08 08:59,buy,1108,0.01,0.80998,,,AUDCHF
2214,2009.04.08 08:59,buy,1109,0.01,70.1760,,,AUDJPY
2215,2009.04.08 08:59,buy,1110,0.01,1.23506,,,AUDNZD
2216,2009.04.08 08:59,sell,1111,0.01,1.86839,,,EURAUD
2217,2009.04.08 09:00,buy,1112,0.01,0.70468,,,AUDUSD
2218,2009.04.09 08:55,close,1106,0.01,2.06541,15.71,13889.61,GBPAUD
2219,2009.04.09 08:59,close,1110,0.01,1.22270,-10.56,13879.05,AUDNZD
2220,2009.04.09 08:59,close,1111,0.01,1.86589,2.87,13881.92,EURAUD
2221,2009.04.09 09:00,close,1107,0.01,0.87913,3.28,13885.20,AUDCAD
2222,2009.04.09 09:00,close,1108,0.01,0.81640,7.06,13892.26,AUDCHF
2223,2009.04.09 09:00,close,1109,0.01,71.4400,12.97,13905.23,AUDJPY
2224,2009.04.09 09:00,close,1112,0.01,0.71351,9.03,13914.26,AUDUSD
2225,2009.04.14 09:25,sell,1113,0.01,2.04982,,,GBPAUD
2226,2009.04.14 09:30,buy,1114,0.01,0.88785,,,AUDCAD
2227,2009.04.14 09:30,buy,1115,0.01,0.82749,,,AUDCHF
2228,2009.04.14 09:30,buy,1116,0.01,72.3160,,,AUDJPY
2229,2009.04.14 09:30,buy,1117,0.01,1.23396,,,AUDNZD
2230,2009.04.14 09:30,buy,1118,0.01,0.72618,,,AUDUSD
2231,2009.04.14 09:30,sell,1119,0.01,1.82909,,,EURAUD
2232,2009.04.14 22:25,sell,1120,0.01,1.83189,,,EURAUD
2233,2009.04.14 22:25,sell,1121,0.01,1.83182,,,EURAUD
2234,2009.04.14 22:29,buy,1122,0.01,0.82390,,,AUDCHF
2235,2009.04.14 22:29,buy,1123,0.01,0.82394,,,AUDCHF
2236,2009.04.14 22:29,buy,1124,0.01,71.6750,,,AUDJPY
2237,2009.04.14 22:29,buy,1125,0.01,71.6820,,,AUDJPY
2238,2009.04.14 22:29,buy,1126,0.01,1.24217,,,AUDNZD
2239,2009.04.14 22:30,buy,1127,0.01,0.87957,,,AUDCAD
2240,2009.04.14 22:30,buy,1128,0.01,0.87918,,,AUDCAD
2241,2009.04.14 22:30,buy,1129,0.01,1.24155,,,AUDNZD
2242,2009.04.14 22:30,buy,1130,0.01,0.72406,,,AUDUSD
2243,2009.04.14 22:30,buy,1131,0.01,0.72386,,,AUDUSD
2244,2009.04.14 22:30,sell,1132,0.01,2.05657,,,GBPAUD
2245,2009.04.14 22:30,sell,1133,0.01,2.05733,,,GBPAUD
2246,2009.04.15 00:55,sell,1134,0.01,1.83381,,,EURAUD
2247,2009.04.15 00:57,sell,1135,0.01,2.06087,,,GBPAUD
2248,2009.04.15 00:59,buy,1136,0.01,0.87786,,,AUDCAD
2249,2009.04.15 00:59,buy,1137,0.01,71.5410,,,AUDJPY
2250,2009.04.15 00:59,buy,1138,0.01,1.23963,,,AUDNZD
2251,2009.04.15 01:00,buy,1139,0.01,0.82249,,,AUDCHF
2252,2009.04.15 01:00,buy,1140,0.01,0.72330,,,AUDUSD
2253,2009.04.15 01:09,sell,1141,0.01,1.83508,,,EURAUD
2254,2009.04.15 01:12,sell,1142,0.01,2.06198,,,GBPAUD
2255,2009.04.15 01:14,buy,1143,0.01,0.87691,,,AUDCAD
2256,2009.04.15 01:14,buy,1144,0.01,71.3750,,,AUDJPY
2257,2009.04.15 01:14,buy,1145,0.01,1.23914,,,AUDNZD
2258,2009.04.15 01:14,buy,1146,0.01,0.72236,,,AUDUSD
2259,2009.04.15 01:15,buy,1147,0.01,0.82134,,,AUDCHF
2260,2009.04.15 07:25,sell,1148,0.01,1.84513,,,EURAUD
2261,2009.04.15 07:25,sell,1149,0.01,1.84516,,,EURAUD
2262,2009.04.15 07:27,buy,1150,0.01,70.7290,,,AUDJPY
2263,2009.04.15 07:27,buy,1151,0.01,70.7240,,,AUDJPY
2264,2009.04.15 07:28,buy,1152,0.01,0.81922,,,AUDCHF
2265,2009.04.15 07:28,buy,1153,0.01,0.81921,,,AUDCHF
2266,2009.04.15 07:29,buy,1154,0.01,1.24130,,,AUDNZD
2267,2009.04.15 07:29,buy,1155,0.01,1.24134,,,AUDNZD
2268,2009.04.15 07:29,sell,1156,0.01,2.07146,,,GBPAUD
2269,2009.04.15 07:29,sell,1157,0.01,2.07137,,,GBPAUD
2270,2009.04.15 07:30,buy,1158,0.01,0.87383,,,AUDCAD
2271,2009.04.15 07:30,buy,1159,0.01,0.87385,,,AUDCAD
2272,2009.04.15 07:30,buy,1160,0.01,0.71877,,,AUDUSD
2273,2009.04.15 07:30,buy,1161,0.01,0.71881,,,AUDUSD
2274,2009.04.15 07:34,buy,1162,0.01,70.8420,,,AUDJPY
2275,2009.04.15 07:34,sell,1163,0.01,1.84420,,,EURAUD
2276,2009.04.15 07:36,sell,1164,0.01,2.07164,,,GBPAUD
2277,2009.04.15 07:37,buy,1165,0.01,0.81896,,,AUDCHF
2278,2009.04.15 07:37,buy,1166,0.01,1.24079,,,AUDNZD
2279,2009.04.15 07:38,buy,1167,0.01,0.87275,,,AUDCAD
2280,2009.04.15 07:39,buy,1168,0.01,0.71789,,,AUDUSD
2281,2009.04.15 07:46,buy,1169,0.01,70.6290,,,AUDJPY
2282,2009.04.15 07:47,sell,1170,0.01,2.07390,,,GBPAUD
2283,2009.04.15 07:48,buy,1171,0.01,0.87220,,,AUDCAD
2284,2009.04.15 07:48,buy,1172,0.01,0.81837,,,AUDCHF
2285,2009.04.15 07:48,buy,1173,0.01,1.23970,,,AUDNZD
2286,2009.04.15 07:48,sell,1174,0.01,1.84720,,,EURAUD
2287,2009.04.15 07:51,buy,1175,0.01,0.71760,,,AUDUSD
2288,2009.04.15 19:44,close,1174,0.01,1.82095,27.04,13941.30,EURAUD
2289,2009.04.15 19:44,close,1163,0.01,1.82095,23.95,13965.25,EURAUD
2290,2009.04.15 19:44,close,1149,0.01,1.82095,24.94,13990.19,EURAUD
2291,2009.04.15 19:44,close,1148,0.01,1.82095,24.91,14015.10,EURAUD
2292,2009.04.15 19:44,close,1141,0.01,1.82095,14.56,14029.66,EURAUD
2293,2009.04.15 19:44,close,1134,0.01,1.82095,13.25,14042.91,EURAUD
2294,2009.04.15 19:44,close,1121,0.01,1.82095,11.30,14054.21,EURAUD
2295,2009.04.15 19:44,close,1120,0.01,1.82095,11.37,14065.58,EURAUD
2296,2009.04.15 19:44,close,1119,0.01,1.82095,8.48,14074.06,EURAUD
2297,2009.04.15 19:48,close,1170,0.01,2.06851,5.56,14079.62,GBPAUD
2298,2009.04.15 19:48,close,1164,0.01,2.06851,3.23,14082.85,GBPAUD
2299,2009.04.15 19:48,close,1157,0.01,2.06851,2.95,14085.80,GBPAUD
2300,2009.04.15 19:48,close,1156,0.01,2.06851,3.04,14088.84,GBPAUD
2301,2009.04.15 19:48,close,1142,0.01,2.06851,-6.73,14082.11,GBPAUD
2302,2009.04.15 19:48,close,1135,0.01,2.06851,-7.87,14074.24,GBPAUD
2303,2009.04.15 19:48,close,1133,0.01,2.06851,-11.42,14062.82,GBPAUD
2304,2009.04.15 19:48,close,1132,0.01,2.06851,-12.20,14050.62,GBPAUD
2305,2009.04.15 19:48,close,1113,0.01,2.06851,-19.16,14031.46,GBPAUD
2306,2009.04.15 19:49,close,1171,0.01,0.87294,0.74,14032.20,AUDCAD
2307,2009.04.15 19:49,close,1167,0.01,0.87294,0.19,14032.39,AUDCAD
2308,2009.04.15 19:49,close,1159,0.01,0.87294,-0.90,14031.49,AUDCAD
2309,2009.04.15 19:49,close,1158,0.01,0.87294,-0.88,14030.61,AUDCAD
2310,2009.04.15 19:49,close,1143,0.01,0.87294,-3.93,14026.68,AUDCAD
2311,2009.04.15 19:49,close,1136,0.01,0.87294,-4.88,14021.80,AUDCAD
2312,2009.04.15 19:49,close,1128,0.01,0.87294,-6.15,14015.65,AUDCAD
2313,2009.04.15 19:49,close,1127,0.01,0.87294,-6.53,14009.12,AUDCAD
2314,2009.04.15 19:49,close,1114,0.01,0.87294,-14.75,13994.37,AUDCAD
2315,2009.04.15 19:49,close,1172,0.01,0.82781,10.09,14004.46,AUDCHF
2316,2009.04.15 19:49,close,1165,0.01,0.82781,9.46,14013.92,AUDCHF
2317,2009.04.15 19:49,close,1153,0.01,0.82781,9.19,14023.11,AUDCHF
2318,2009.04.15 19:49,close,1152,0.01,0.82781,9.18,14032.29,AUDCHF
2319,2009.04.15 19:49,close,1147,0.01,0.82781,6.91,14039.20,AUDCHF
2320,2009.04.15 19:49,close,1139,0.01,0.82781,5.68,14044.88,AUDCHF
2321,2009.04.15 19:49,close,1123,0.01,0.82781,4.19,14049.07,AUDCHF
2322,2009.04.15 19:49,close,1122,0.01,0.82781,4.24,14053.31,AUDCHF
2323,2009.04.15 19:49,close,1115,0.01,0.82781,0.40,14053.71,AUDCHF
2324,2009.04.15 19:49,close,1169,0.01,71.7050,10.85,14064.56,AUDJPY
2325,2009.04.15 19:49,close,1162,0.01,71.7050,8.70,14073.26,AUDJPY
2326,2009.04.15 19:49,close,1151,0.01,71.7050,9.89,14083.15,AUDJPY
2327,2009.04.15 19:49,close,1150,0.01,71.7050,9.84,14092.99,AUDJPY
2328,2009.04.15 19:49,close,1144,0.01,71.7050,3.32,14096.31,AUDJPY
2329,2009.04.15 19:49,close,1137,0.01,71.7050,1.65,14097.96,AUDJPY
2330,2009.04.15 19:49,close,1125,0.01,71.7050,0.30,14098.26,AUDJPY
2331,2009.04.15 19:49,close,1124,0.01,71.7050,0.37,14098.63,AUDJPY
2332,2009.04.15 19:49,close,1116,0.01,71.7050,-6.10,14092.53,AUDJPY
2333,2009.04.15 19:49,close,1173,0.01,1.25012,8.89,14101.42,AUDNZD
2334,2009.04.15 19:49,close,1166,0.01,1.25012,7.96,14109.38,AUDNZD
2335,2009.04.15 19:49,close,1155,0.01,1.25012,7.49,14116.87,AUDNZD
2336,2009.04.15 19:49,close,1154,0.01,1.25012,7.53,14124.40,AUDNZD
2337,2009.04.15 19:49,close,1145,0.01,1.25012,9.37,14133.77,AUDNZD
2338,2009.04.15 19:49,close,1138,0.01,1.25012,8.95,14142.72,AUDNZD
2339,2009.04.15 19:49,close,1129,0.01,1.25012,7.31,14150.03,AUDNZD
2340,2009.04.15 19:49,close,1126,0.01,1.25012,6.78,14156.81,AUDNZD
2341,2009.04.15 19:49,close,1117,0.01,1.25012,13.79,14170.60,AUDNZD
2342,2009.04.15 19:49,close,1175,0.01,0.72357,5.97,14176.57,AUDUSD
2343,2009.04.15 19:49,close,1168,0.01,0.72357,5.68,14182.25,AUDUSD
2344,2009.04.15 19:49,close,1161,0.01,0.72357,4.76,14187.01,AUDUSD
2345,2009.04.15 19:49,close,1160,0.01,0.72357,4.80,14191.81,AUDUSD
2346,2009.04.15 19:49,close,1146,0.01,0.72357,1.21,14193.02,AUDUSD
2347,2009.04.15 19:49,close,1140,0.01,0.72357,0.27,14193.29,AUDUSD
2348,2009.04.15 19:49,close,1131,0.01,0.72357,-0.22,14193.07,AUDUSD
2349,2009.04.15 19:49,close,1130,0.01,0.72357,-0.42,14192.65,AUDUSD
2350,2009.04.15 19:49,close,1118,0.01,0.72357,-2.54,14190.11,AUDUSD
2351,2009.04.16 12:24,sell,1176,0.01,2.06830,,,GBPAUD
2352,2009.04.16 12:25,sell,1177,0.01,1.82678,,,EURAUD
2353,2009.04.16 12:29,buy,1178,0.01,0.87072,,,AUDCAD
2354,2009.04.16 12:29,buy,1179,0.01,0.82930,,,AUDCHF
2355,2009.04.16 12:29,buy,1180,0.01,71.2550,,,AUDJPY
2356,2009.04.16 12:29,buy,1181,0.01,1.26162,,,AUDNZD
2357,2009.04.16 12:29,buy,1182,0.01,0.72219,,,AUDUSD
2358,2009.04.16 19:55,sell,1183,0.01,2.08255,,,GBPAUD
2359,2009.04.16 19:55,sell,1184,0.01,2.08254,,,GBPAUD
2360,2009.04.16 19:59,buy,1185,0.01,0.86892,,,AUDCAD
2361,2009.04.16 19:59,buy,1186,0.01,1.25776,,,AUDNZD
2362,2009.04.16 19:59,sell,1187,0.01,1.83585,,,EURAUD
2363,2009.04.16 20:00,buy,1188,0.01,0.86895,,,AUDCAD
2364,2009.04.16 20:00,buy,1189,0.01,0.82354,,,AUDCHF
2365,2009.04.16 20:00,buy,1190,0.01,0.82349,,,AUDCHF
2366,2009.04.16 20:00,buy,1191,0.01,71.0460,,,AUDJPY
2367,2009.04.16 20:00,buy,1192,0.01,71.0450,,,AUDJPY
2368,2009.04.16 20:00,buy,1193,0.01,1.25786,,,AUDNZD
2369,2009.04.16 20:00,buy,1194,0.01,0.71617,,,AUDUSD
2370,2009.04.16 20:00,buy,1195,0.01,0.71610,,,AUDUSD
2371,2009.04.16 20:00,sell,1196,0.01,1.83580,,,EURAUD
2372,2009.04.17 09:25,close,1196,0.01,1.81769,18.76,14208.87,EURAUD
2373,2009.04.17 09:25,close,1187,0.01,1.81769,18.81,14227.68,EURAUD
2374,2009.04.17 09:25,close,1177,0.01,1.81769,9.46,14237.14,EURAUD
2375,2009.04.17 09:29,close,1190,0.01,0.83284,10.05,14247.19,AUDCHF
2376,2009.04.17 09:29,close,1189,0.01,0.83284,10.00,14257.19,AUDCHF
2377,2009.04.17 09:29,close,1179,0.01,0.83284,3.84,14261.03,AUDCHF
2378,2009.04.17 09:29,close,1192,0.01,71.7750,7.43,14268.46,AUDJPY
2379,2009.04.17 09:29,close,1191,0.01,71.7750,7.42,14275.88,AUDJPY
2380,2009.04.17 09:29,close,1180,0.01,71.7750,5.32,14281.20,AUDJPY
2381,2009.04.17 09:29,close,1184,0.01,2.05772,25.68,14306.88,GBPAUD
2382,2009.04.17 09:29,close,1183,0.01,2.05772,25.69,14332.57,GBPAUD
2383,2009.04.17 09:29,close,1176,0.01,2.05772,11.01,14343.58,GBPAUD
2384,2009.04.17 09:30,close,1188,0.01,0.87262,3.68,14347.26,AUDCAD
2385,2009.04.17 09:30,close,1185,0.01,0.87262,3.71,14350.97,AUDCAD
2386,2009.04.17 09:30,close,1178,0.01,0.87262,1.93,14352.90,AUDCAD
2387,2009.04.17 09:30,close,1193,0.01,1.25572,-1.83,14351.07,AUDNZD
2388,2009.04.17 09:30,close,1186,0.01,1.25572,-1.74,14349.33,AUDNZD
2389,2009.04.17 09:30,close,1181,0.01,1.25572,-5.04,14344.29,AUDNZD
2390,2009.04.17 09:30,close,1195,0.01,0.72105,5.02,14349.31,AUDUSD
2391,2009.04.17 09:30,close,1194,0.01,0.72105,4.95,14354.26,AUDUSD
2392,2009.04.17 09:30,close,1182,0.01,0.72105,-1.08,14353.18,AUDUSD
2393,2009.04.20 04:55,sell,1197,0.01,1.81334,,,EURAUD
2394,2009.04.20 04:57,buy,1198,0.01,70.6630,,,AUDJPY
2395,2009.04.20 04:59,buy,1199,0.01,0.83810,,,AUDCHF
2396,2009.04.20 04:59,sell,1200,0.01,2.05543,,,GBPAUD
2397,2009.04.20 05:00,buy,1201,0.01,0.87226,,,AUDCAD
2398,2009.04.20 05:00,buy,1202,0.01,1.26529,,,AUDNZD
2399,2009.04.20 05:00,buy,1203,0.01,0.71655,,,AUDUSD
2400,2009.04.21 00:12,sell,1204,0.01,1.84975,,,EURAUD
2401,2009.04.21 00:13,sell,1205,0.01,1.84971,,,EURAUD
2402,2009.04.21 00:13,sell,1206,0.01,1.84979,,,EURAUD
2403,2009.04.21 00:13,sell,1207,0.01,1.84977,,,EURAUD
2404,2009.04.21 00:15,buy,1208,0.01,68.5050,,,AUDJPY
2405,2009.04.21 00:15,buy,1209,0.01,68.5030,,,AUDJPY
2406,2009.04.21 00:15,buy,1210,0.01,68.5000,,,AUDJPY
2407,2009.04.21 00:15,buy,1211,0.01,68.4980,,,AUDJPY
2408,2009.04.21 00:16,buy,1212,0.01,0.86564,,,AUDCAD
2409,2009.04.21 00:16,buy,1213,0.01,0.86562,,,AUDCAD
2410,2009.04.21 00:16,buy,1214,0.01,0.81685,,,AUDCHF
2411,2009.04.21 00:16,buy,1215,0.01,0.81687,,,AUDCHF
2412,2009.04.21 00:16,buy,1216,0.01,0.81684,,,AUDCHF
2413,2009.04.21 00:16,buy,1217,0.01,1.26286,,,AUDNZD
2414,2009.04.21 00:16,sell,1218,0.01,2.08005,,,GBPAUD
2415,2009.04.21 00:17,buy,1219,0.01,0.86561,,,AUDCAD
2416,2009.04.21 00:17,buy,1220,0.01,0.86559,,,AUDCAD
2417,2009.04.21 00:17,buy,1221,0.01,0.81694,,,AUDCHF
2418,2009.04.21 00:17,buy,1222,0.01,1.26296,,,AUDNZD
2419,2009.04.21 00:17,buy,1223,0.01,1.26291,,,AUDNZD
2420,2009.04.21 00:17,buy,1224,0.01,1.26295,,,AUDNZD
2421,2009.04.21 00:17,buy,1225,0.03,0.69902,,,AUDUSD
2422,2009.04.21 00:17,buy,1226,0.01,0.69905,,,AUDUSD
2423,2009.04.21 00:17,sell,1227,0.01,2.07995,,,GBPAUD
2424,2009.04.21 00:17,sell,1228,0.01,2.08000,,,GBPAUD
2425,2009.04.21 00:17,sell,1229,0.01,2.07995,,,GBPAUD
2426,2009.04.21 23:55,close,1207,0.01,1.82365,26.91,14380.09,EURAUD
2427,2009.04.21 23:55,close,1206,0.01,1.82365,26.93,14407.02,EURAUD
2428,2009.04.21 23:55,close,1205,0.01,1.82365,26.85,14433.87,EURAUD
2429,2009.04.21 23:55,close,1204,0.01,1.82365,26.89,14460.76,EURAUD
2430,2009.04.21 23:55,close,1197,0.01,1.82365,-10.52,14450.24,EURAUD
2431,2009.04.21 23:57,close,1221,0.01,0.82844,12.30,14462.54,AUDCHF
2432,2009.04.21 23:57,close,1216,0.01,0.82844,12.40,14474.94,AUDCHF
2433,2009.04.21 23:57,close,1215,0.01,0.82844,12.37,14487.31,AUDCHF
2434,2009.04.21 23:57,close,1214,0.01,0.82844,12.39,14499.70,AUDCHF
2435,2009.04.21 23:57,close,1199,0.01,0.82844,-10.26,14489.44,AUDCHF
2436,2009.04.21 23:59,close,1220,0.01,0.87716,11.47,14500.91,AUDCAD
2437,2009.04.21 23:59,close,1219,0.01,0.87716,11.45,14512.36,AUDCAD
2438,2009.04.21 23:59,close,1213,0.01,0.87716,11.44,14523.80,AUDCAD
2439,2009.04.21 23:59,close,1212,0.01,0.87716,11.42,14535.22,AUDCAD
2440,2009.04.21 23:59,close,1201,0.01,0.87716,4.90,14540.12,AUDCAD
2441,2009.04.21 23:59,close,1211,0.01,70.0140,15.29,14555.41,AUDJPY
2442,2009.04.21 23:59,close,1210,0.01,70.0140,15.27,14570.68,AUDJPY
2443,2009.04.21 23:59,close,1209,0.01,70.0140,15.24,14585.92,AUDJPY
2444,2009.04.21 23:59,close,1208,0.01,70.0140,15.22,14601.14,AUDJPY
2445,2009.04.21 23:59,close,1198,0.01,70.0140,-6.47,14594.67,AUDJPY
2446,2009.04.21 23:59,close,1224,0.01,1.26088,-1.76,14592.91,AUDNZD
2447,2009.04.21 23:59,close,1223,0.01,1.26088,-1.73,14591.18,AUDNZD
2448,2009.04.21 23:59,close,1222,0.01,1.26088,-1.77,14589.41,AUDNZD
2449,2009.04.21 23:59,close,1217,0.01,1.26088,-1.69,14587.72,AUDNZD
2450,2009.04.21 23:59,close,1202,0.01,1.26088,-3.76,14583.96,AUDNZD
2451,2009.04.21 23:59,close,1229,0.01,2.06668,13.67,14597.63,GBPAUD
2452,2009.04.21 23:59,close,1228,0.01,2.06668,13.72,14611.35,GBPAUD
2453,2009.04.21 23:59,close,1227,0.01,2.06668,13.67,14625.02,GBPAUD
2454,2009.04.21 23:59,close,1218,0.01,2.06668,13.77,14638.79,GBPAUD
2455,2009.04.21 23:59,close,1200,0.01,2.06668,-11.49,14627.30,GBPAUD
2456,2009.04.22 00:00,close,1226,0.01,0.70958,10.59,14637.89,AUDUSD
2457,2009.04.22 00:00,close,1225,0.03,0.70958,31.88,14669.77,AUDUSD
2458,2009.04.22 00:00,close,1203,0.01,0.70958,-6.84,14662.93,AUDUSD
2459,2009.04.22 06:55,sell,1230,0.01,1.83574,,,EURAUD
2460,2009.04.22 06:59,buy,1231,0.01,69.1900,,,AUDJPY
2461,2009.04.22 06:59,sell,1232,0.01,2.07668,,,GBPAUD
2462,2009.04.22 07:00,buy,1233,0.01,0.87209,,,AUDCAD
2463,2009.04.22 07:00,buy,1234,0.01,0.82248,,,AUDCHF
2464,2009.04.22 07:00,buy,1235,0.01,1.26670,,,AUDNZD
2465,2009.04.22 07:00,buy,1236,0.01,0.70418,,,AUDUSD
2466,2009.04.22 18:25,close,1232,0.01,2.04155,36.20,14699.13,GBPAUD
2467,2009.04.22 18:28,close,1233,0.01,0.87744,5.31,14704.44,AUDCAD
2468,2009.04.22 18:29,close,1235,0.01,1.27170,4.27,14708.71,AUDNZD
2469,2009.04.22 18:30,close,1234,0.01,0.82460,2.26,14710.97,AUDCHF
2470,2009.04.22 18:30,close,1231,0.01,69.3370,1.48,14712.45,AUDJPY
2471,2009.04.22 18:30,close,1236,0.01,0.70818,4.00,14716.45,AUDUSD
2472,2009.04.22 18:30,close,1230,0.01,1.83438,1.40,14717.85,EURAUD
2473,2009.04.24 08:25,sell,1237,0.01,1.84877,,,EURAUD
2474,2009.04.24 08:29,buy,1238,0.01,0.87120,,,AUDCAD
2475,2009.04.24 08:29,buy,1239,0.01,0.81805,,,AUDCHF
2476,2009.04.24 08:29,buy,1240,0.01,69.1040,,,AUDJPY
2477,2009.04.24 08:29,buy,1241,0.01,1.26669,,,AUDNZD
2478,2009.04.24 08:29,sell,1242,0.01,2.05714,,,GBPAUD
2479,2009.04.24 08:30,buy,1243,0.01,0.71278,,,AUDUSD
2480,2009.04.24 13:55,close,1242,0.01,2.02989,28.08,14745.93,GBPAUD
2481,2009.04.24 13:59,close,1237,0.01,1.84196,7.01,14752.94,EURAUD
2482,2009.04.24 14:00,close,1238,0.01,0.87492,3.69,14756.63,AUDCAD
2483,2009.04.24 14:00,close,1239,0.01,0.81992,2.00,14758.63,AUDCHF
2484,2009.04.24 14:00,close,1240,0.01,69.5870,4.87,14763.50,AUDJPY
2485,2009.04.24 14:00,close,1241,0.01,1.26594,-0.64,14762.86,AUDNZD
2486,2009.04.24 14:00,close,1243,0.01,0.71865,5.87,14768.73,AUDUSD
2487,2009.04.27 06:55,sell,1244,0.01,1.84661,,,EURAUD
2488,2009.04.27 06:58,buy,1245,0.01,0.86778,,,AUDCAD
2489,2009.04.27 06:58,buy,1246,0.01,0.81536,,,AUDCHF
2490,2009.04.27 06:58,buy,1247,0.01,68.9170,,,AUDJPY
2491,2009.04.27 06:58,buy,1248,0.01,1.26363,,,AUDNZD
2492,2009.04.27 06:58,sell,1249,0.01,2.04804,,,GBPAUD
2493,2009.04.27 07:00,buy,1250,0.01,0.71318,,,AUDUSD
2494,2009.04.27 22:28,sell,1251,0.01,1.83287,,,EURAUD
2495,2009.04.27 22:30,sell,1252,0.01,2.06044,,,GBPAUD
2496,2009.04.27 22:33,buy,1253,0.01,0.86578,,,AUDCAD
2497,2009.04.27 22:33,buy,1254,0.01,0.82117,,,AUDCHF
2498,2009.04.27 22:33,buy,1255,0.01,68.7880,,,AUDJPY
2499,2009.04.27 22:33,buy,1256,0.01,1.25116,,,AUDNZD
2500,2009.04.27 22:33,buy,1257,0.01,0.71096,,,AUDUSD
2501,2009.04.28 03:58,sell,1258,0.01,1.84213,,,EURAUD
2502,2009.04.28 03:59,sell,1259,0.01,1.84206,,,EURAUD
2503,2009.04.28 04:02,sell,1260,0.01,2.06648,,,GBPAUD
2504,2009.04.28 04:02,sell,1261,0.01,2.06660,,,GBPAUD
2505,2009.04.28 04:03,buy,1262,0.01,0.86094,,,AUDCAD
2506,2009.04.28 04:03,buy,1263,0.01,0.86099,,,AUDCAD
2507,2009.04.28 04:03,buy,1264,0.01,0.81719,,,AUDCHF
2508,2009.04.28 04:03,buy,1265,0.01,0.81729,,,AUDCHF
2509,2009.04.28 04:03,buy,1266,0.01,68.2370,,,AUDJPY
2510,2009.04.28 04:03,buy,1267,0.01,68.2400,,,AUDJPY
2511,2009.04.28 04:03,buy,1268,0.01,1.26140,,,AUDNZD
2512,2009.04.28 04:03,buy,1269,0.01,1.26132,,,AUDNZD
2513,2009.04.28 04:03,buy,1270,0.01,0.70703,,,AUDUSD
2514,2009.04.28 04:04,buy,1271,0.01,0.70708,,,AUDUSD
2515,2009.04.28 11:25,sell,1272,0.01,2.07207,,,GBPAUD
2516,2009.04.28 11:25,sell,1273,0.01,2.07206,,,GBPAUD
2517,2009.04.28 11:25,sell,1274,0.01,2.07205,,,GBPAUD
2518,2009.04.28 11:26,sell,1275,0.01,1.85458,,,EURAUD
2519,2009.04.28 11:26,sell,1276,0.01,1.85457,,,EURAUD
2520,2009.04.28 11:26,sell,1277,0.01,1.85456,,,EURAUD
2521,2009.04.28 11:30,buy,1278,0.01,0.85802,,,AUDCAD
2522,2009.04.28 11:30,buy,1279,0.01,0.85806,,,AUDCAD
2523,2009.04.28 11:30,buy,1280,0.01,0.85810,,,AUDCAD
2524,2009.04.28 11:30,buy,1281,0.01,0.81140,,,AUDCHF
2525,2009.04.28 11:30,buy,1282,0.01,0.81142,,,AUDCHF
2526,2009.04.28 11:30,buy,1283,0.01,0.81144,,,AUDCHF
2527,2009.04.28 11:30,buy,1284,0.01,67.3140,,,AUDJPY
2528,2009.04.28 11:30,buy,1285,0.01,67.3100,,,AUDJPY
2529,2009.04.28 11:30,buy,1286,0.01,67.3070,,,AUDJPY
2530,2009.04.28 11:30,buy,1287,0.01,1.26185,,,AUDNZD
2531,2009.04.28 11:30,buy,1288,0.01,1.26184,,,AUDNZD
2532,2009.04.28 11:30,buy,1289,0.01,1.26183,,,AUDNZD
2533,2009.04.28 11:30,buy,1290,0.02,0.70117,,,AUDUSD
2534,2009.04.28 11:30,buy,1291,0.01,0.70116,,,AUDUSD
2535,2009.04.29 03:55,close,1277,0.01,1.85171,3.04,14771.77,EURAUD
2536,2009.04.29 03:55,close,1276,0.01,1.85171,3.05,14774.82,EURAUD
2537,2009.04.29 03:55,close,1275,0.01,1.85171,3.06,14777.88,EURAUD
2538,2009.04.29 03:55,close,1259,0.01,1.85171,-9.84,14768.04,EURAUD
2539,2009.04.29 03:55,close,1258,0.01,1.85171,-9.77,14758.27,EURAUD
2540,2009.04.29 03:55,close,1251,0.01,1.85171,-19.21,14739.06,EURAUD
2541,2009.04.29 03:55,close,1244,0.01,1.85171,-5.05,14734.01,EURAUD
2542,2009.04.29 03:58,close,1283,0.01,0.81129,-0.10,14733.91,AUDCHF
2543,2009.04.29 03:58,close,1282,0.01,0.81129,-0.08,14733.83,AUDCHF
2544,2009.04.29 03:58,close,1281,0.01,0.81129,-0.06,14733.77,AUDCHF
2545,2009.04.29 03:58,close,1265,0.01,0.81129,-6.36,14727.41,AUDCHF
2546,2009.04.29 03:58,close,1264,0.01,0.81129,-6.25,14721.16,AUDCHF
2547,2009.04.29 03:58,close,1254,0.01,0.81129,-10.44,14710.72,AUDCHF
2548,2009.04.29 03:58,close,1246,0.01,0.81129,-4.23,14706.49,AUDCHF
2549,2009.04.29 03:58,close,1274,0.01,2.06405,8.34,14714.83,GBPAUD
2550,2009.04.29 03:58,close,1273,0.01,2.06405,8.35,14723.18,GBPAUD
2551,2009.04.29 03:58,close,1272,0.01,2.06405,8.36,14731.54,GBPAUD
2552,2009.04.29 03:58,close,1261,0.01,2.06405,2.72,14734.26,GBPAUD
2553,2009.04.29 03:58,close,1260,0.01,2.06405,2.60,14736.86,GBPAUD
2554,2009.04.29 03:58,close,1252,0.01,2.06405,-3.52,14733.34,GBPAUD
2555,2009.04.29 03:58,close,1249,0.01,2.06405,-16.30,14717.04,GBPAUD
2556,2009.04.29 03:59,close,1280,0.01,0.86410,5.99,14723.03,AUDCAD
2557,2009.04.29 03:59,close,1279,0.01,0.86410,6.03,14729.06,AUDCAD
2558,2009.04.29 03:59,close,1278,0.01,0.86410,6.07,14735.13,AUDCAD
2559,2009.04.29 03:59,close,1263,0.01,0.86410,3.13,14738.26,AUDCAD
2560,2009.04.29 03:59,close,1262,0.01,0.86410,3.18,14741.44,AUDCAD
2561,2009.04.29 03:59,close,1253,0.01,0.86410,-1.57,14739.87,AUDCAD
2562,2009.04.29 03:59,close,1245,0.01,0.86410,-3.56,14736.31,AUDCAD
2563,2009.04.29 03:59,close,1286,0.01,68.7600,14.73,14751.04,AUDJPY
2564,2009.04.29 03:59,close,1285,0.01,68.7600,14.70,14765.74,AUDJPY
2565,2009.04.29 03:59,close,1284,0.01,68.7600,14.66,14780.40,AUDJPY
2566,2009.04.29 03:59,close,1267,0.01,68.7600,5.32,14785.72,AUDJPY
2567,2009.04.29 03:59,close,1266,0.01,68.7600,5.35,14791.07,AUDJPY
2568,2009.04.29 03:59,close,1255,0.01,68.7600,-0.13,14790.94,AUDJPY
2569,2009.04.29 03:59,close,1247,0.01,68.7600,-1.43,14789.51,AUDJPY
2570,2009.04.29 03:59,close,1289,0.01,1.25891,-2.49,14787.02,AUDNZD
2571,2009.04.29 03:59,close,1288,0.01,1.25891,-2.50,14784.52,AUDNZD
2572,2009.04.29 03:59,close,1287,0.01,1.25891,-2.50,14782.02,AUDNZD
2573,2009.04.29 03:59,close,1269,0.01,1.25891,-2.05,14779.97,AUDNZD
2574,2009.04.29 03:59,close,1268,0.01,1.25891,-2.12,14777.85,AUDNZD
2575,2009.04.29 03:59,close,1256,0.01,1.25891,6.61,14784.46,AUDNZD
2576,2009.04.29 03:59,close,1248,0.01,1.25891,-4.03,14780.43,AUDNZD
2577,2009.04.29 04:00,close,1291,0.01,0.70991,8.81,14789.24,AUDUSD
2578,2009.04.29 04:00,close,1290,0.02,0.70991,17.61,14806.85,AUDUSD
2579,2009.04.29 04:00,close,1271,0.01,0.70991,2.90,14809.75,AUDUSD
2580,2009.04.29 04:00,close,1270,0.01,0.70991,2.94,14812.69,AUDUSD
2581,2009.04.29 04:00,close,1257,0.01,0.70991,-0.92,14811.77,AUDUSD
2582,2009.04.29 04:00,close,1250,0.01,0.70991,-3.14,14808.63,AUDUSD
2583,2009.05.01 16:55,sell,1292,0.01,2.04228,,,GBPAUD
2584,2009.05.01 16:59,buy,1293,0.01,0.86571,,,AUDCAD
2585,2009.05.01 16:59,buy,1294,0.01,0.82669,,,AUDCHF
2586,2009.05.01 16:59,buy,1295,0.01,72.1870,,,AUDJPY
2587,2009.05.01 16:59,buy,1296,0.01,1.28015,,,AUDNZD
2588,2009.05.01 16:59,sell,1297,0.01,1.82264,,,EURAUD
2589,2009.05.01 17:00,buy,1298,0.01,0.72708,,,AUDUSD
2590,2009.05.04 04:25,close,1297,0.01,1.81023,12.89,14821.52,EURAUD
2591,2009.05.04 04:27,close,1295,0.01,73.0850,9.12,14830.64,AUDJPY
2592,2009.05.04 04:28,close,1294,0.01,0.83360,7.44,14838.08,AUDCHF
2593,2009.05.04 04:29,close,1292,0.01,2.03250,10.18,14848.26,GBPAUD
2594,2009.05.04 04:30,close,1293,0.01,0.86893,3.24,14851.50,AUDCAD
2595,2009.05.04 04:30,close,1296,0.01,1.28206,1.64,14853.14,AUDNZD
2596,2009.05.04 04:30,close,1298,0.01,0.73587,8.85,14861.99,AUDUSD
2597,2009.05.06 01:55,sell,1299,0.01,1.79967,,,EURAUD
2598,2009.05.06 02:00,buy,1300,0.01,0.86964,,,AUDCAD
2599,2009.05.06 02:00,buy,1301,0.01,0.83814,,,AUDCHF
2600,2009.05.06 02:00,buy,1302,0.01,72.9730,,,AUDJPY
2601,2009.05.06 02:00,buy,1303,0.01,1.27605,,,AUDNZD
2602,2009.05.06 02:00,buy,1304,0.01,0.73900,,,AUDUSD
2603,2009.05.06 02:00,sell,1305,0.01,2.03550,,,GBPAUD
2604,2009.05.06 04:25,sell,1306,0.01,1.80080,,,EURAUD
2605,2009.05.06 04:29,buy,1307,0.01,1.27418,,,AUDNZD
2606,2009.05.06 04:29,sell,1308,0.01,2.03765,,,GBPAUD
2607,2009.05.06 04:30,buy,1309,0.01,0.86856,,,AUDCAD
2608,2009.05.06 04:30,buy,1310,0.01,0.83804,,,AUDCHF
2609,2009.05.06 04:30,buy,1311,0.01,72.4640,,,AUDJPY
2610,2009.05.06 04:30,buy,1312,0.01,0.73699,,,AUDUSD
2611,2009.05.06 08:05,sell,1313,0.01,1.80083,,,EURAUD
2612,2009.05.06 08:10,buy,1314,0.01,0.86785,,,AUDCAD
2613,2009.05.06 08:10,buy,1315,0.01,0.83649,,,AUDCHF
2614,2009.05.06 08:10,buy,1316,0.01,72.2800,,,AUDJPY
2615,2009.05.06 08:10,buy,1317,0.01,1.27428,,,AUDNZD
2616,2009.05.06 08:10,buy,1318,0.01,0.73728,,,AUDUSD
2617,2009.05.06 08:10,sell,1319,0.01,2.03998,,,GBPAUD
2618,2009.05.06 20:55,close,1313,0.01,1.78062,20.83,14882.82,EURAUD
2619,2009.05.06 20:55,close,1306,0.01,1.78062,20.79,14903.61,EURAUD
2620,2009.05.06 20:55,close,1299,0.01,1.78062,19.63,14923.24,EURAUD
2621,2009.05.06 20:59,close,1314,0.01,0.87365,5.75,14928.99,AUDCAD
2622,2009.05.06 20:59,close,1309,0.01,0.87365,5.05,14934.04,AUDCAD
2623,2009.05.06 20:59,close,1300,0.01,0.87365,3.98,14938.02,AUDCAD
2624,2009.05.06 20:59,close,1319,0.01,2.01946,21.15,14959.17,GBPAUD
2625,2009.05.06 20:59,close,1308,0.01,2.01946,18.74,14977.91,GBPAUD
2626,2009.05.06 20:59,close,1305,0.01,2.01946,16.53,14994.44,GBPAUD
2627,2009.05.06 21:00,close,1315,0.01,0.84650,10.70,15005.14,AUDCHF
2628,2009.05.06 21:00,close,1310,0.01,0.84650,9.04,15014.18,AUDCHF
2629,2009.05.06 21:00,close,1301,0.01,0.84650,8.93,15023.11,AUDCHF
2630,2009.05.06 21:00,close,1316,0.01,73.6140,13.46,15036.57,AUDJPY
2631,2009.05.06 21:00,close,1311,0.01,73.6140,11.60,15048.17,AUDJPY
2632,2009.05.06 21:00,close,1302,0.01,73.6140,6.47,15054.64,AUDJPY
2633,2009.05.06 21:00,close,1317,0.01,1.27937,4.35,15058.99,AUDNZD
2634,2009.05.06 21:00,close,1307,0.01,1.27937,4.43,15063.42,AUDNZD
2635,2009.05.06 21:00,close,1303,0.01,1.27937,2.83,15066.25,AUDNZD
2636,2009.05.06 21:00,close,1318,0.01,0.74874,11.46,15077.71,AUDUSD
2637,2009.05.06 21:00,close,1312,0.01,0.74874,11.75,15089.46,AUDUSD
2638,2009.05.06 21:00,close,1304,0.01,0.74874,9.74,15099.20,AUDUSD
2639,2009.05.11 04:25,sell,1320,0.01,1.77900,,,EURAUD
2640,2009.05.11 04:29,buy,1321,0.01,0.84732,,,AUDCHF
2641,2009.05.11 04:30,buy,1322,0.01,0.88156,,,AUDCAD
2642,2009.05.11 04:30,buy,1323,0.01,75.4120,,,AUDJPY
2643,2009.05.11 04:30,buy,1324,0.01,1.26306,,,AUDNZD
2644,2009.05.11 04:30,buy,1325,0.01,0.76648,,,AUDUSD
2645,2009.05.11 04:30,sell,1326,0.01,1.98620,,,GBPAUD
2646,2009.05.11 11:58,sell,1327,0.01,1.97728,,,GBPAUD
2647,2009.05.11 11:59,sell,1328,0.01,1.78133,,,EURAUD
2648,2009.05.11 12:03,buy,1329,0.01,0.88032,,,AUDCAD
2649,2009.05.11 12:03,buy,1330,0.01,0.84539,,,AUDCHF
2650,2009.05.11 12:03,buy,1331,0.01,74.6420,,,AUDJPY
2651,2009.05.11 12:03,buy,1332,0.01,1.26312,,,AUDNZD
2652,2009.05.11 12:03,buy,1333,0.01,0.76258,,,AUDUSD
2653,2009.05.11 13:27,sell,1334,0.01,1.98474,,,GBPAUD
2654,2009.05.11 13:32,buy,1335,0.01,0.88027,,,AUDCAD
2655,2009.05.11 13:32,buy,1336,0.01,0.84517,,,AUDCHF
2656,2009.05.11 13:32,buy,1337,0.01,74.5350,,,AUDJPY
2657,2009.05.11 13:32,buy,1338,0.01,1.26414,,,AUDNZD
2658,2009.05.11 13:32,buy,1339,0.01,0.76189,,,AUDUSD
2659,2009.05.11 13:32,sell,1340,0.01,1.78134,,,EURAUD
2660,2009.05.12 11:13,close,1334,0.01,1.99389,-9.32,15089.88,GBPAUD
2661,2009.05.12 11:13,close,1327,0.01,1.99389,-17.01,15072.87,GBPAUD
2662,2009.05.12 11:13,close,1326,0.01,1.99389,-7.82,15065.05,GBPAUD
2663,2009.05.12 11:16,close,1340,0.01,1.78155,-0.12,15064.93,EURAUD
2664,2009.05.12 11:16,close,1328,0.01,1.78155,-0.13,15064.80,EURAUD
2665,2009.05.12 11:16,close,1320,0.01,1.78155,-2.53,15062.27,EURAUD
2666,2009.05.12 11:18,close,1335,0.01,0.88881,8.51,15070.78,AUDCAD
2667,2009.05.12 11:18,close,1329,0.01,0.88881,8.46,15079.24,AUDCAD
2668,2009.05.12 11:18,close,1322,0.01,0.88881,7.23,15086.47,AUDCAD
2669,2009.05.12 11:18,close,1336,0.01,0.84629,1.26,15087.73,AUDCHF
2670,2009.05.12 11:18,close,1330,0.01,0.84629,1.02,15088.75,AUDCHF
2671,2009.05.12 11:18,close,1321,0.01,0.84629,-1.04,15087.71,AUDCHF
2672,2009.05.12 11:18,close,1337,0.01,74.9470,4.22,15091.93,AUDJPY
2673,2009.05.12 11:18,close,1331,0.01,74.9470,3.14,15095.07,AUDJPY
2674,2009.05.12 11:18,close,1323,0.01,74.9470,-4.62,15090.45,AUDJPY
2675,2009.05.12 11:18,close,1338,0.01,1.26278,-1.16,15089.29,AUDNZD
2676,2009.05.12 11:18,close,1332,0.01,1.26278,-0.29,15089.00,AUDNZD
2677,2009.05.12 11:18,close,1324,0.01,1.26278,-0.24,15088.76,AUDNZD
2678,2009.05.12 11:18,close,1339,0.01,0.76742,5.60,15094.36,AUDUSD
2679,2009.05.12 11:18,close,1333,0.01,0.76742,4.91,15099.27,AUDUSD
2680,2009.05.12 11:18,close,1325,0.01,0.76742,1.00,15100.27,AUDUSD
2681,2009.05.13 16:10,sell,1341,0.01,1.99823,,,GBPAUD
2682,2009.05.13 16:15,buy,1342,0.01,0.88325,,,AUDCAD
2683,2009.05.13 16:15,buy,1343,0.01,0.83829,,,AUDCHF
2684,2009.05.13 16:15,buy,1344,0.01,72.9360,,,AUDJPY
2685,2009.05.13 16:15,buy,1345,0.01,1.27512,,,AUDNZD
2686,2009.05.13 16:15,buy,1346,0.01,0.75809,,,AUDUSD
2687,2009.05.13 16:15,sell,1347,0.01,1.79443,,,EURAUD
2688,2009.05.13 19:55,sell,1348,0.01,2.00595,,,GBPAUD
2689,2009.05.13 19:58,sell,1349,0.01,1.79943,,,EURAUD
2690,2009.05.13 19:59,buy,1350,0.01,0.83703,,,AUDCHF
2691,2009.05.13 20:00,buy,1351,0.01,0.88570,,,AUDCAD
2692,2009.05.13 20:00,buy,1352,0.01,72.4080,,,AUDJPY
2693,2009.05.13 20:00,buy,1353,0.01,1.27684,,,AUDNZD
2694,2009.05.13 20:00,buy,1354,0.01,0.75548,,,AUDUSD
2695,2009.05.13 20:01,sell,1355,0.01,2.00572,,,GBPAUD
2696,2009.05.13 20:06,buy,1356,0.01,0.88547,,,AUDCAD
2697,2009.05.13 20:06,buy,1357,0.01,0.83636,,,AUDCHF
2698,2009.05.13 20:06,buy,1358,0.01,72.2980,,,AUDJPY
2699,2009.05.13 20:06,buy,1359,0.01,1.27524,,,AUDNZD
2700,2009.05.13 20:06,buy,1360,0.01,0.75477,,,AUDUSD
2701,2009.05.13 20:06,sell,1361,0.01,1.79994,,,EURAUD
2702,2009.05.13 20:17,sell,1362,0.01,2.00732,,,GBPAUD
2703,2009.05.13 20:21,sell,1363,0.01,1.80241,,,EURAUD
2704,2009.05.13 20:22,buy,1364,0.01,0.88431,,,AUDCAD
2705,2009.05.13 20:22,buy,1365,0.01,0.83558,,,AUDCHF
2706,2009.05.13 20:22,buy,1366,0.01,72.1480,,,AUDJPY
2707,2009.05.13 20:22,buy,1367,0.01,1.27511,,,AUDNZD
2708,2009.05.13 20:22,buy,1368,0.01,0.75341,,,AUDUSD
2709,2009.05.14 00:55,buy,1369,0.01,71.7640,,,AUDJPY
2710,2009.05.14 00:55,sell,1370,0.01,1.80319,,,EURAUD
2711,2009.05.14 00:58,sell,1371,0.01,2.01028,,,GBPAUD
2712,2009.05.14 00:59,buy,1372,0.01,0.88497,,,AUDCAD
2713,2009.05.14 00:59,buy,1373,0.01,0.83425,,,AUDCHF
2714,2009.05.14 00:59,buy,1374,0.01,1.27127,,,AUDNZD
2715,2009.05.14 01:00,buy,1375,0.01,0.75344,,,AUDUSD
2716,2009.05.14 09:55,sell,1376,0.01,2.01502,,,GBPAUD
2717,2009.05.14 09:57,sell,1377,0.01,1.80767,,,EURAUD
2718,2009.05.14 10:00,buy,1378,0.01,0.88135,,,AUDCAD
2719,2009.05.14 10:00,buy,1379,0.01,0.83364,,,AUDCHF
2720,2009.05.14 10:00,buy,1380,0.01,71.8380,,,AUDJPY
2721,2009.05.14 10:00,buy,1381,0.01,1.27052,,,AUDNZD
2722,2009.05.14 10:00,buy,1382,0.01,0.75193,,,AUDUSD
2723,2009.05.14 12:58,sell,1383,0.01,2.01235,,,GBPAUD
2724,2009.05.14 13:03,buy,1384,0.01,0.88028,,,AUDCAD
2725,2009.05.14 13:03,buy,1385,0.01,0.83134,,,AUDCHF
2726,2009.05.14 13:03,buy,1386,0.01,71.4640,,,AUDJPY
2727,2009.05.14 13:03,buy,1387,0.01,1.26923,,,AUDNZD
2728,2009.05.14 13:03,buy,1388,0.01,0.74958,,,AUDUSD
2729,2009.05.14 13:03,sell,1389,0.01,1.81192,,,EURAUD
2730,2009.05.14 13:27,sell,1390,0.01,2.01422,,,GBPAUD
2731,2009.05.14 13:31,buy,1391,0.01,0.83128,,,AUDCHF
2732,2009.05.14 13:31,buy,1392,0.01,1.27155,,,AUDNZD
2733,2009.05.14 13:31,sell,1393,0.01,1.81089,,,EURAUD
2734,2009.05.14 13:32,buy,1394,0.01,0.88054,,,AUDCAD
2735,2009.05.14 13:32,buy,1395,0.01,71.2730,,,AUDJPY
2736,2009.05.14 13:32,buy,1396,0.01,0.74755,,,AUDUSD
2737,2009.05.14 18:55,close,1393,0.01,1.79647,14.86,15115.13,EURAUD
2738,2009.05.14 18:55,close,1389,0.01,1.79647,15.92,15131.05,EURAUD
2739,2009.05.14 18:55,close,1377,0.01,1.79647,11.54,15142.59,EURAUD
2740,2009.05.14 18:55,close,1370,0.01,1.79647,6.93,15149.52,EURAUD
2741,2009.05.14 18:55,close,1363,0.01,1.79647,6.41,15155.93,EURAUD
2742,2009.05.14 18:55,close,1361,0.01,1.79647,3.87,15159.80,EURAUD
2743,2009.05.14 18:55,close,1349,0.01,1.79647,3.34,15163.14,EURAUD
2744,2009.05.14 18:55,close,1347,0.01,1.79647,-1.81,15161.33,EURAUD
2745,2009.05.14 18:57,close,1391,0.01,0.83750,6.65,15167.98,AUDCHF
2746,2009.05.14 18:57,close,1385,0.01,0.83750,6.58,15174.56,AUDCHF
2747,2009.05.14 18:57,close,1379,0.01,0.83750,4.12,15178.68,AUDCHF
2748,2009.05.14 18:57,close,1373,0.01,0.83750,3.47,15182.15,AUDCHF
2749,2009.05.14 18:57,close,1365,0.01,0.83750,2.24,15184.39,AUDCHF
2750,2009.05.14 18:57,close,1357,0.01,0.83750,1.41,15185.80,AUDCHF
2751,2009.05.14 18:57,close,1350,0.01,0.83750,0.69,15186.49,AUDCHF
2752,2009.05.14 18:57,close,1343,0.01,0.83750,-0.66,15185.83,AUDCHF
2753,2009.05.14 18:57,close,1392,0.01,1.27066,-0.76,15185.07,AUDNZD
2754,2009.05.14 18:57,close,1387,0.01,1.27066,1.22,15186.29,AUDNZD
2755,2009.05.14 18:57,close,1381,0.01,1.27066,0.11,15186.40,AUDNZD
2756,2009.05.14 18:57,close,1374,0.01,1.27066,-0.53,15185.87,AUDNZD
2757,2009.05.14 18:57,close,1367,0.01,1.27066,-3.81,15182.06,AUDNZD
2758,2009.05.14 18:57,close,1359,0.01,1.27066,-3.92,15178.14,AUDNZD
2759,2009.05.14 18:57,close,1353,0.01,1.27066,-5.29,15172.85,AUDNZD
2760,2009.05.14 18:57,close,1345,0.01,1.27066,-3.82,15169.03,AUDNZD
2761,2009.05.14 18:57,close,1390,0.01,2.00366,10.88,15179.91,GBPAUD
2762,2009.05.14 18:57,close,1383,0.01,2.00366,8.96,15188.87,GBPAUD
2763,2009.05.14 18:57,close,1376,0.01,2.00366,11.71,15200.58,GBPAUD
2764,2009.05.14 18:57,close,1371,0.01,2.00366,6.82,15207.40,GBPAUD
2765,2009.05.14 18:57,close,1362,0.01,2.00366,4.07,15211.47,GBPAUD
2766,2009.05.14 18:57,close,1355,0.01,2.00366,2.42,15213.89,GBPAUD
2767,2009.05.14 18:57,close,1348,0.01,2.00366,2.66,15216.55,GBPAUD
2768,2009.05.14 18:57,close,1341,0.01,2.00366,-5.29,15211.26,GBPAUD
2769,2009.05.14 18:58,close,1395,0.01,72.4260,11.63,15222.89,AUDJPY
2770,2009.05.14 18:58,close,1386,0.01,72.4260,9.71,15232.60,AUDJPY
2771,2009.05.14 18:58,close,1380,0.01,72.4260,5.93,15238.53,AUDJPY
2772,2009.05.14 18:58,close,1369,0.01,72.4260,6.68,15245.21,AUDJPY
2773,2009.05.14 18:58,close,1366,0.01,72.4260,3.03,15248.24,AUDJPY
2774,2009.05.14 18:58,close,1358,0.01,72.4260,1.52,15249.76,AUDJPY
2775,2009.05.14 18:58,close,1352,0.01,72.4260,0.41,15250.17,AUDJPY
2776,2009.05.14 18:58,close,1344,0.01,72.4260,-4.92,15245.25,AUDJPY
2777,2009.05.14 18:59,close,1394,0.01,0.88776,7.17,15252.42,AUDCAD
2778,2009.05.14 18:59,close,1384,0.01,0.88776,7.42,15259.84,AUDCAD
2779,2009.05.14 18:59,close,1378,0.01,0.88776,6.36,15266.20,AUDCAD
2780,2009.05.14 18:59,close,1372,0.01,0.88776,2.77,15268.97,AUDCAD
2781,2009.05.14 18:59,close,1364,0.01,0.88776,3.56,15272.53,AUDCAD
2782,2009.05.14 18:59,close,1356,0.01,0.88776,2.41,15274.94,AUDCAD
2783,2009.05.14 18:59,close,1351,0.01,0.88776,2.18,15277.12,AUDCAD
2784,2009.05.14 18:59,close,1342,0.01,0.88776,4.61,15281.73,AUDCAD
2785,2009.05.14 19:00,close,1396,0.01,0.75741,9.86,15291.59,AUDUSD
2786,2009.05.14 19:00,close,1388,0.01,0.75741,7.83,15299.42,AUDUSD
2787,2009.05.14 19:00,close,1382,0.01,0.75741,5.48,15304.90,AUDUSD
2788,2009.05.14 19:00,close,1375,0.01,0.75741,3.97,15308.87,AUDUSD
2789,2009.05.14 19:00,close,1368,0.01,0.75741,4.20,15313.07,AUDUSD
2790,2009.05.14 19:00,close,1360,0.01,0.75741,2.84,15315.91,AUDUSD
2791,2009.05.14 19:00,close,1354,0.01,0.75741,2.13,15318.04,AUDUSD
2792,2009.05.14 19:00,close,1346,0.01,0.75741,-0.49,15317.55,AUDUSD
2793,2009.05.15 13:55,sell,1397,0.01,1.79648,,,EURAUD
2794,2009.05.15 13:58,buy,1398,0.01,0.83655,,,AUDCHF
2795,2009.05.15 13:58,sell,1399,0.01,2.01552,,,GBPAUD
2796,2009.05.15 13:59,buy,1400,0.01,0.88536,,,AUDCAD
2797,2009.05.15 13:59,buy,1401,0.01,71.5550,,,AUDJPY
2798,2009.05.15 13:59,buy,1402,0.01,1.28004,,,AUDNZD
2799,2009.05.15 14:00,buy,1403,0.01,0.75263,,,AUDUSD
2800,2009.05.18 00:57,buy,1404,0.01,0.84160,,,AUDCHF
2801,2009.05.18 01:00,sell,1405,0.01,1.79748,,,EURAUD
2802,2009.05.18 01:01,buy,1406,0.01,0.88310,,,AUDCAD
2803,2009.05.18 01:01,buy,1407,0.01,71.3170,,,AUDJPY
2804,2009.05.18 01:02,buy,1408,0.01,1.28121,,,AUDNZD
2805,2009.05.18 01:02,buy,1409,0.01,0.74963,,,AUDUSD
2806,2009.05.18 01:02,sell,1410,0.01,2.02226,,,GBPAUD
2807,2009.05.18 01:17,buy,1411,0.01,0.84153,,,AUDCHF
2808,2009.05.18 01:18,buy,1412,0.01,0.88219,,,AUDCAD
2809,2009.05.18 01:19,buy,1413,0.01,71.1710,,,AUDJPY
2810,2009.05.18 01:19,buy,1414,0.01,1.27851,,,AUDNZD
2811,2009.05.18 01:19,sell,1415,0.01,1.79904,,,EURAUD
2812,2009.05.18 01:19,sell,1416,0.01,2.02402,,,GBPAUD
2813,2009.05.18 01:22,buy,1417,0.01,0.84058,,,AUDCHF
2814,2009.05.18 01:22,buy,1418,0.01,0.74838,,,AUDUSD
2815,2009.05.18 01:24,sell,1419,0.01,1.79994,,,EURAUD
2816,2009.05.18 01:26,buy,1420,0.01,1.27798,,,AUDNZD
2817,2009.05.18 01:27,buy,1421,0.01,0.88052,,,AUDCAD
2818,2009.05.18 01:27,buy,1422,0.01,71.0350,,,AUDJPY
2819,2009.05.18 01:27,buy,1423,0.01,0.74715,,,AUDUSD
2820,2009.05.18 01:27,sell,1424,0.01,2.02618,,,GBPAUD
2821,2009.05.18 03:49,sell,1425,0.01,1.79932,,,EURAUD
2822,2009.05.18 03:52,buy,1426,0.01,70.6720,,,AUDJPY
2823,2009.05.18 03:54,buy,1427,0.01,0.88032,,,AUDCAD
2824,2009.05.18 03:54,buy,1428,0.01,0.83947,,,AUDCHF
2825,2009.05.18 03:54,buy,1429,0.01,1.27578,,,AUDNZD
2826,2009.05.18 03:54,buy,1430,0.01,0.74624,,,AUDUSD
2827,2009.05.18 03:54,sell,1431,0.01,2.02834,,,GBPAUD
2828,2009.05.18 15:56,close,1425,0.01,1.77872,21.23,15338.78,EURAUD
2829,2009.05.18 15:56,close,1419,0.01,1.77872,21.87,15360.65,EURAUD
2830,2009.05.18 15:56,close,1415,0.01,1.77872,20.94,15381.59,EURAUD
2831,2009.05.18 15:56,close,1405,0.01,1.77872,19.33,15400.92,EURAUD
2832,2009.05.18 15:56,close,1397,0.01,1.77872,18.40,15419.32,EURAUD
2833,2009.05.18 16:01,close,1427,0.01,0.88465,4.29,15423.61,AUDCAD
2834,2009.05.18 16:01,close,1421,0.01,0.88465,4.10,15427.71,AUDCAD
2835,2009.05.18 16:01,close,1412,0.01,0.88465,2.44,15430.15,AUDCAD
2836,2009.05.18 16:01,close,1406,0.01,0.88465,1.54,15431.69,AUDCAD
2837,2009.05.18 16:01,close,1400,0.01,0.88465,-0.67,15431.02,AUDCAD
2838,2009.05.18 16:01,close,1428,0.01,0.84880,9.97,15440.99,AUDCHF
2839,2009.05.18 16:01,close,1417,0.01,0.84880,8.79,15449.78,AUDCHF
2840,2009.05.18 16:01,close,1411,0.01,0.84880,7.77,15457.55,AUDCHF
2841,2009.05.18 16:01,close,1404,0.01,0.84880,7.69,15465.24,AUDCHF
2842,2009.05.18 16:01,close,1398,0.01,0.84880,13.15,15478.39,AUDCHF
2843,2009.05.18 16:01,close,1426,0.01,72.5750,19.20,15497.59,AUDJPY
2844,2009.05.18 16:01,close,1422,0.01,72.5750,15.53,15513.12,AUDJPY
2845,2009.05.18 16:01,close,1413,0.01,72.5750,14.16,15527.28,AUDJPY
2846,2009.05.18 16:01,close,1407,0.01,72.5750,12.69,15539.97,AUDJPY
2847,2009.05.18 16:01,close,1401,0.01,72.5750,10.36,15550.33,AUDJPY
2848,2009.05.18 16:01,close,1429,0.01,1.28518,8.03,15558.36,AUDNZD
2849,2009.05.18 16:01,close,1420,0.01,1.28518,6.15,15564.51,AUDNZD
2850,2009.05.18 16:01,close,1414,0.01,1.28518,5.70,15570.21,AUDNZD
2851,2009.05.18 16:01,close,1408,0.01,1.28518,3.39,15573.60,AUDNZD
2852,2009.05.18 16:01,close,1402,0.01,1.28518,4.39,15577.99,AUDNZD
2853,2009.05.18 16:01,close,1430,0.01,0.75762,11.38,15589.37,AUDUSD
2854,2009.05.18 16:01,close,1423,0.01,0.75762,10.47,15599.84,AUDUSD
2855,2009.05.18 16:01,close,1418,0.01,0.75762,9.24,15609.08,AUDUSD
2856,2009.05.18 16:01,close,1409,0.01,0.75762,7.99,15617.07,AUDUSD
2857,2009.05.18 16:01,close,1403,0.01,0.75762,5.06,15622.13,AUDUSD
2858,2009.05.18 16:01,close,1431,0.01,2.01578,12.94,15635.07,GBPAUD
2859,2009.05.18 16:01,close,1424,0.01,2.01578,10.72,15645.79,GBPAUD
2860,2009.05.18 16:01,close,1416,0.01,2.01578,8.49,15654.28,GBPAUD
2861,2009.05.18 16:01,close,1410,0.01,2.01578,6.68,15660.96,GBPAUD
2862,2009.05.18 16:01,close,1399,0.01,2.01578,-0.17,15660.79,GBPAUD
2863,2009.05.20 04:55,sell,1432,0.01,1.76516,,,EURAUD
2864,2009.05.20 04:58,buy,1433,0.01,0.89155,,,AUDCAD
2865,2009.05.20 04:58,buy,1434,0.01,0.85609,,,AUDCHF
2866,2009.05.20 04:58,buy,1435,0.01,73.6370,,,AUDJPY
2867,2009.05.20 04:58,sell,1436,0.01,2.00675,,,GBPAUD
2868,2009.05.20 04:59,buy,1437,0.01,1.28346,,,AUDNZD
2869,2009.05.20 05:00,buy,1438,0.01,0.77057,,,AUDUSD
2870,2009.05.20 12:55,sell,1439,0.01,1.77011,,,EURAUD
2871,2009.05.20 12:59,buy,1440,0.01,0.89145,,,AUDCAD
2872,2009.05.20 12:59,buy,1441,0.01,0.85344,,,AUDCHF
2873,2009.05.20 12:59,buy,1442,0.01,73.9460,,,AUDJPY
2874,2009.05.20 12:59,sell,1443,0.01,2.00768,,,GBPAUD
2875,2009.05.20 13:00,buy,1444,0.01,1.27916,,,AUDNZD
2876,2009.05.20 13:00,buy,1445,0.01,0.77160,,,AUDUSD
2877,2009.05.20 19:25,sell,1446,0.01,1.77547,,,EURAUD
2878,2009.05.20 19:29,buy,1447,0.01,0.88711,,,AUDCAD
2879,2009.05.20 19:29,buy,1448,0.01,0.85447,,,AUDCHF
2880,2009.05.20 19:29,sell,1449,0.01,2.01968,,,GBPAUD
2881,2009.05.20 19:30,buy,1450,0.01,73.8250,,,AUDJPY
2882,2009.05.20 19:30,buy,1451,0.01,1.27928,,,AUDNZD
2883,2009.05.20 19:30,buy,1452,0.01,0.77679,,,AUDUSD
2884,2009.05.21 00:55,buy,1453,0.01,73.5050,,,AUDJPY
2885,2009.05.21 00:55,buy,1454,0.01,73.5120,,,AUDJPY
2886,2009.05.21 00:56,buy,1455,0.01,0.85280,,,AUDCHF
2887,2009.05.21 00:56,buy,1456,0.01,0.85276,,,AUDCHF
2888,2009.05.21 00:58,sell,1457,0.01,1.77649,,,EURAUD
2889,2009.05.21 00:58,sell,1458,0.01,1.77650,,,EURAUD
2890,2009.05.21 00:59,buy,1459,0.01,0.88474,,,AUDCAD
2891,2009.05.21 00:59,buy,1460,0.01,0.88471,,,AUDCAD
2892,2009.05.21 00:59,buy,1461,0.01,1.27905,,,AUDNZD
2893,2009.05.21 00:59,buy,1462,0.01,1.27897,,,AUDNZD
2894,2009.05.21 00:59,sell,1463,0.01,2.03212,,,GBPAUD
2895,2009.05.21 00:59,sell,1464,0.01,2.03204,,,GBPAUD
2896,2009.05.21 01:00,buy,1465,0.01,0.77496,,,AUDUSD
2897,2009.05.21 01:00,buy,1466,0.01,0.77493,,,AUDUSD
2898,2009.05.21 01:18,buy,1467,0.01,73.3850,,,AUDJPY
2899,2009.05.21 01:20,sell,1468,0.01,1.77784,,,EURAUD
2900,2009.05.21 01:21,buy,1469,0.01,0.85242,,,AUDCHF
2901,2009.05.21 01:23,buy,1470,0.01,0.88421,,,AUDCAD
2902,2009.05.21 01:23,buy,1471,0.01,1.27792,,,AUDNZD
2903,2009.05.21 01:23,buy,1472,0.01,0.77471,,,AUDUSD
2904,2009.05.21 01:23,sell,1473,0.01,2.03339,,,GBPAUD
2905,2009.05.21 03:56,buy,1474,0.01,73.1260,,,AUDJPY
2906,2009.05.21 03:56,sell,1475,0.01,1.77944,,,EURAUD
2907,2009.05.21 04:00,buy,1476,0.01,1.27352,,,AUDNZD
2908,2009.05.21 04:01,buy,1477,0.01,0.88370,,,AUDCAD
2909,2009.05.21 04:01,buy,1478,0.01,0.85220,,,AUDCHF
2910,2009.05.21 04:01,buy,1479,0.01,0.77446,,,AUDUSD
2911,2009.05.21 04:01,sell,1480,0.01,2.03430,,,GBPAUD
2912,2009.05.21 11:37,sell,1481,0.01,1.78985,,,EURAUD
2913,2009.05.21 11:41,sell,1482,0.01,2.02541,,,GBPAUD
2914,2009.05.21 11:42,buy,1483,0.01,0.88048,,,AUDCAD
2915,2009.05.21 11:42,buy,1484,0.01,0.84791,,,AUDCHF
2916,2009.05.21 11:42,buy,1485,0.01,73.0040,,,AUDJPY
2917,2009.05.21 11:42,buy,1486,0.01,1.27433,,,AUDNZD
2918,2009.05.21 11:42,buy,1487,0.01,0.77160,,,AUDUSD
2919,2009.05.21 11:48,sell,1488,0.01,1.78989,,,EURAUD
2920,2009.05.21 11:52,buy,1489,0.01,1.27476,,,AUDNZD
2921,2009.05.21 11:52,sell,1490,0.01,2.03097,,,GBPAUD
2922,2009.05.21 11:53,buy,1491,0.01,0.87950,,,AUDCAD
2923,2009.05.21 11:53,buy,1492,0.01,0.84783,,,AUDCHF
2924,2009.05.21 11:53,buy,1493,0.01,72.9720,,,AUDJPY
2925,2009.05.21 11:53,buy,1494,0.01,0.77159,,,AUDUSD
2926,2009.05.21 15:55,sell,1495,0.01,1.78654,,,EURAUD
2927,2009.05.21 15:59,buy,1496,0.01,0.88097,,,AUDCAD
2928,2009.05.21 15:59,buy,1497,0.01,1.27258,,,AUDNZD
2929,2009.05.21 15:59,sell,1498,0.01,2.04240,,,GBPAUD
2930,2009.05.21 16:00,buy,1499,0.01,0.84976,,,AUDCHF
2931,2009.05.21 16:00,buy,1500,0.01,72.7340,,,AUDJPY
2932,2009.05.21 16:00,buy,1501,0.01,0.76896,,,AUDUSD
2933,2009.05.26 04:55,sell,1502,0.01,1.79602,,,EURAUD
2934,2009.05.26 04:59,buy,1503,0.01,0.84491,,,AUDCHF
2935,2009.05.26 05:00,buy,1504,0.01,0.87700,,,AUDCAD
2936,2009.05.26 05:00,buy,1505,0.01,73.6690,,,AUDJPY
2937,2009.05.26 05:00,buy,1506,0.01,1.25816,,,AUDNZD
2938,2009.05.26 05:00,buy,1507,0.01,0.77823,,,AUDUSD
2939,2009.05.26 05:00,sell,1508,0.01,2.04140,,,GBPAUD
2940,2009.05.26 13:25,sell,1509,0.01,2.05016,,,GBPAUD
2941,2009.05.26 13:25,sell,1510,0.01,2.05021,,,GBPAUD
2942,2009.05.26 13:27,sell,1511,0.01,1.79688,,,EURAUD
2943,2009.05.26 13:27,sell,1512,0.01,1.79690,,,EURAUD
2944,2009.05.26 13:28,buy,1513,0.01,1.26072,,,AUDNZD
2945,2009.05.26 13:28,buy,1514,0.01,1.26074,,,AUDNZD
2946,2009.05.26 13:29,buy,1515,0.01,0.87477,,,AUDCAD
2947,2009.05.26 13:29,buy,1516,0.01,0.87480,,,AUDCAD
2948,2009.05.26 13:29,buy,1517,0.01,0.84301,,,AUDCHF
2949,2009.05.26 13:29,buy,1518,0.01,0.84303,,,AUDCHF
2950,2009.05.26 13:29,buy,1519,0.01,73.3230,,,AUDJPY
2951,2009.05.26 13:29,buy,1520,0.01,73.3240,,,AUDJPY
2952,2009.05.26 13:30,buy,1521,0.01,0.77276,,,AUDUSD
2953,2009.05.26 13:30,buy,1522,0.01,0.77274,,,AUDUSD
2954,2009.05.26 20:55,close,1512,0.01,1.78190,15.46,15676.25,EURAUD
2955,2009.05.26 20:55,close,1511,0.01,1.78190,15.44,15691.69,EURAUD
2956,2009.05.26 20:55,close,1502,0.01,1.78190,14.55,15706.24,EURAUD
2957,2009.05.26 20:55,close,1495,0.01,1.78190,5.07,15711.31,EURAUD
2958,2009.05.26 20:55,close,1488,0.01,1.78190,8.52,15719.83,EURAUD
2959,2009.05.26 20:55,close,1481,0.01,1.78190,8.48,15728.31,EURAUD
2960,2009.05.26 20:55,close,1475,0.01,1.78190,-2.25,15726.06,EURAUD
2961,2009.05.26 20:55,close,1468,0.01,1.78190,-3.89,15722.17,EURAUD
2962,2009.05.26 20:55,close,1458,0.01,1.78190,-5.27,15716.90,EURAUD
2963,2009.05.26 20:55,close,1457,0.01,1.78190,-5.28,15711.62,EURAUD
2964,2009.05.26 20:55,close,1446,0.01,1.78190,-6.04,15705.58,EURAUD
2965,2009.05.26 20:55,close,1439,0.01,1.78190,-11.56,15694.02,EURAUD
2966,2009.05.26 20:55,close,1432,0.01,1.78190,-16.66,15677.36,EURAUD
2967,2009.05.26 20:59,close,1516,0.01,0.87654,1.73,15679.09,AUDCAD
2968,2009.05.26 20:59,close,1515,0.01,0.87654,1.76,15680.85,AUDCAD
2969,2009.05.26 20:59,close,1504,0.01,0.87654,-0.45,15680.40,AUDCAD
2970,2009.05.26 20:59,close,1496,0.01,0.87654,-4.26,15676.14,AUDCAD
2971,2009.05.26 20:59,close,1491,0.01,0.87654,-2.80,15673.34,AUDCAD
2972,2009.05.26 20:59,close,1483,0.01,0.87654,-3.77,15669.57,AUDCAD
2973,2009.05.26 20:59,close,1477,0.01,0.87654,-6.97,15662.60,AUDCAD
2974,2009.05.26 20:59,close,1470,0.01,0.87654,-7.47,15655.13,AUDCAD
2975,2009.05.26 20:59,close,1460,0.01,0.87654,-7.97,15647.16,AUDCAD
2976,2009.05.26 20:59,close,1459,0.01,0.87654,-8.00,15639.16,AUDCAD
2977,2009.05.26 20:59,close,1447,0.01,0.87654,-10.22,15628.94,AUDCAD
2978,2009.05.26 20:59,close,1440,0.01,0.87654,-14.53,15614.41,AUDCAD
2979,2009.05.26 20:59,close,1433,0.01,0.87654,-14.63,15599.78,AUDCAD
2980,2009.05.26 20:59,close,1518,0.01,0.84979,7.23,15607.01,AUDCHF
2981,2009.05.26 20:59,close,1517,0.01,0.84979,7.25,15614.26,AUDCHF
2982,2009.05.26 20:59,close,1503,0.01,0.84979,5.22,15619.48,AUDCHF
2983,2009.05.26 20:59,close,1499,0.01,0.84979,0.22,15619.70,AUDCHF
2984,2009.05.26 20:59,close,1492,0.01,0.84979,2.29,15621.99,AUDCHF
2985,2009.05.26 20:59,close,1484,0.01,0.84979,2.20,15624.19,AUDCHF
2986,2009.05.26 20:59,close,1478,0.01,0.84979,-2.39,15621.80,AUDCHF
2987,2009.05.26 20:59,close,1469,0.01,0.84979,-2.62,15619.18,AUDCHF
2988,2009.05.26 20:59,close,1456,0.01,0.84979,-2.98,15616.20,AUDCHF
2989,2009.05.26 20:59,close,1455,0.01,0.84979,-3.03,15613.17,AUDCHF
2990,2009.05.26 20:59,close,1448,0.01,0.84979,-4.61,15608.56,AUDCHF
2991,2009.05.26 20:59,close,1441,0.01,0.84979,-3.51,15605.05,AUDCHF
2992,2009.05.26 20:59,close,1434,0.01,0.84979,-6.34,15598.71,AUDCHF
2993,2009.05.26 20:59,close,1520,0.01,74.4670,11.53,15610.24,AUDJPY
2994,2009.05.26 20:59,close,1519,0.01,74.4670,11.54,15621.78,AUDJPY
2995,2009.05.26 20:59,close,1505,0.01,74.4670,8.05,15629.83,AUDJPY
2996,2009.05.26 20:59,close,1500,0.01,74.4670,17.70,15647.53,AUDJPY
2997,2009.05.26 20:59,close,1493,0.01,74.4670,15.30,15662.83,AUDJPY
2998,2009.05.26 20:59,close,1485,0.01,74.4670,14.97,15677.80,AUDJPY
2999,2009.05.26 20:59,close,1474,0.01,74.4670,13.74,15691.54,AUDJPY
3000,2009.05.26 20:59,close,1467,0.01,74.4670,11.13,15702.67,AUDJPY
3001,2009.05.26 20:59,close,1454,0.01,74.4670,9.85,15712.52,AUDJPY
3002,2009.05.26 20:59,close,1453,0.01,74.4670,9.92,15722.44,AUDJPY
3003,2009.05.26 20:59,close,1450,0.01,74.4670,6.91,15729.35,AUDJPY
3004,2009.05.26 20:59,close,1442,0.01,74.4670,5.69,15735.04,AUDJPY
3005,2009.05.26 20:59,close,1435,0.01,74.4670,8.81,15743.85,AUDJPY
3006,2009.05.26 20:59,close,1514,0.01,1.25498,-4.92,15738.93,AUDNZD
3007,2009.05.26 20:59,close,1513,0.01,1.25498,-4.90,15734.03,AUDNZD
3008,2009.05.26 20:59,close,1506,0.01,1.25498,-2.72,15731.31,AUDNZD
3009,2009.05.26 20:59,close,1497,0.01,1.25498,-15.03,15716.28,AUDNZD
3010,2009.05.26 20:59,close,1489,0.01,1.25498,-16.89,15699.39,AUDNZD
3011,2009.05.26 20:59,close,1486,0.01,1.25498,-16.53,15682.86,AUDNZD
3012,2009.05.26 20:59,close,1476,0.01,1.25498,-15.84,15667.02,AUDNZD
3013,2009.05.26 20:59,close,1471,0.01,1.25498,-19.59,15647.43,AUDNZD
3014,2009.05.26 20:59,close,1462,0.01,1.25498,-20.49,15626.94,AUDNZD
3015,2009.05.26 20:59,close,1461,0.01,1.25498,-20.56,15606.38,AUDNZD
3016,2009.05.26 20:59,close,1451,0.01,1.25498,-20.76,15585.62,AUDNZD
3017,2009.05.26 20:59,close,1444,0.01,1.25498,-20.66,15564.96,AUDNZD
3018,2009.05.26 20:59,close,1437,0.01,1.25498,-24.33,15540.63,AUDNZD
3019,2009.05.26 20:59,close,1510,0.01,2.02873,22.14,15562.77,GBPAUD
3020,2009.05.26 20:59,close,1509,0.01,2.02873,22.08,15584.85,GBPAUD
3021,2009.05.26 20:59,close,1508,0.01,2.02873,13.06,15597.91,GBPAUD
3022,2009.05.26 20:59,close,1498,0.01,2.02873,14.39,15612.30,GBPAUD
3023,2009.05.26 20:59,close,1490,0.01,2.02873,2.61,15614.91,GBPAUD
3024,2009.05.26 20:59,close,1482,0.01,2.02873,-3.12,15611.79,GBPAUD
3025,2009.05.26 20:59,close,1480,0.01,2.02873,6.04,15617.83,GBPAUD
3026,2009.05.26 20:59,close,1473,0.01,2.02873,5.11,15622.94,GBPAUD
3027,2009.05.26 20:59,close,1464,0.01,2.02873,3.71,15626.65,GBPAUD
3028,2009.05.26 20:59,close,1463,0.01,2.02873,3.80,15630.45,GBPAUD
3029,2009.05.26 20:59,close,1449,0.01,2.02873,-8.73,15621.72,GBPAUD
3030,2009.05.26 20:59,close,1443,0.01,2.02873,-21.10,15600.62,GBPAUD
3031,2009.05.26 20:59,close,1436,0.01,2.02873,-22.05,15578.57,GBPAUD
3032,2009.05.26 21:00,close,1522,0.01,0.78435,11.61,15590.18,AUDUSD
3033,2009.05.26 21:00,close,1521,0.01,0.78435,11.59,15601.77,AUDUSD
3034,2009.05.26 21:00,close,1507,0.01,0.78435,6.12,15607.89,AUDUSD
3035,2009.05.26 21:00,close,1501,0.01,0.78435,15.59,15623.48,AUDUSD
3036,2009.05.26 21:00,close,1494,0.01,0.78435,12.96,15636.44,AUDUSD
3037,2009.05.26 21:00,close,1487,0.01,0.78435,12.95,15649.39,AUDUSD
3038,2009.05.26 21:00,close,1479,0.01,0.78435,10.09,15659.48,AUDUSD
3039,2009.05.26 21:00,close,1472,0.01,0.78435,9.84,15669.32,AUDUSD
3040,2009.05.26 21:00,close,1466,0.01,0.78435,9.62,15678.94,AUDUSD
3041,2009.05.26 21:00,close,1465,0.01,0.78435,9.59,15688.53,AUDUSD
3042,2009.05.26 21:00,close,1452,0.01,0.78435,7.95,15696.48,AUDUSD
3043,2009.05.26 21:00,close,1445,0.01,0.78435,13.14,15709.62,AUDUSD
3044,2009.05.26 21:00,close,1438,0.01,0.78435,14.17,15723.79,AUDUSD
3045,2009.05.28 00:25,sell,1523,0.01,1.77984,,,EURAUD
3046,2009.05.28 00:28,buy,1524,0.01,0.84980,,,AUDCHF
3047,2009.05.28 00:29,sell,1525,0.01,2.05338,,,GBPAUD
3048,2009.05.28 00:30,buy,1526,0.01,0.87179,,,AUDCAD
3049,2009.05.28 00:30,buy,1527,0.01,74.1250,,,AUDJPY
3050,2009.05.28 00:30,buy,1528,0.01,1.26222,,,AUDNZD
3051,2009.05.28 00:30,buy,1529,0.01,0.77740,,,AUDUSD
3052,2009.05.28 12:55,close,1525,0.01,2.03708,16.79,15740.58,GBPAUD
3053,2009.05.28 12:57,close,1523,0.01,1.77245,7.62,15748.20,EURAUD
3054,2009.05.28 12:58,close,1524,0.01,0.85208,2.44,15750.64,AUDCHF
3055,2009.05.28 12:59,close,1526,0.01,0.87466,2.84,15753.48,AUDCAD
3056,2009.05.28 12:59,close,1527,0.01,75.8870,17.77,15771.25,AUDJPY
3057,2009.05.28 12:59,close,1528,0.01,1.25180,-8.89,15762.36,AUDNZD
3058,2009.05.28 13:00,close,1529,0.01,0.78337,5.97,15768.33,AUDUSD
3059,2009.06.03 13:55,sell,1530,0.01,1.74271,,,EURAUD
3060,2009.06.03 13:59,buy,1531,0.01,0.88646,,,AUDCAD
3061,2009.06.03 13:59,buy,1532,0.01,0.87063,,,AUDCHF
3062,2009.06.03 13:59,buy,1533,0.01,78.2300,,,AUDJPY
3063,2009.06.03 13:59,buy,1534,0.01,1.26317,,,AUDNZD
3064,2009.06.03 13:59,sell,1535,0.01,2.02551,,,GBPAUD
3065,2009.06.03 14:00,buy,1536,0.01,0.81469,,,AUDUSD
3066,2009.06.03 23:25,sell,1537,0.01,1.76668,,,EURAUD
3067,2009.06.03 23:25,sell,1538,0.01,1.76666,,,EURAUD
3068,2009.06.03 23:25,sell,1539,0.01,1.76668,,,EURAUD
3069,2009.06.03 23:27,buy,1540,0.01,0.89063,,,AUDCAD
3070,2009.06.03 23:27,buy,1541,0.01,0.89066,,,AUDCAD
3071,2009.06.03 23:27,buy,1542,0.01,0.89068,,,AUDCAD
3072,2009.06.03 23:29,buy,1543,0.01,0.85754,,,AUDCHF
3073,2009.06.03 23:29,buy,1544,0.01,0.85749,,,AUDCHF
3074,2009.06.03 23:29,buy,1545,0.01,0.85744,,,AUDCHF
3075,2009.06.03 23:29,buy,1546,0.01,1.26114,,,AUDNZD
3076,2009.06.03 23:29,buy,1547,0.01,1.26113,,,AUDNZD
3077,2009.06.03 23:29,buy,1548,0.01,1.26117,,,AUDNZD
3078,2009.06.03 23:29,sell,1549,0.01,2.03541,,,GBPAUD
3079,2009.06.03 23:29,sell,1550,0.01,2.03532,,,GBPAUD
3080,2009.06.03 23:29,sell,1551,0.01,2.03524,,,GBPAUD
3081,2009.06.03 23:30,buy,1552,0.01,76.8450,,,AUDJPY
3082,2009.06.03 23:30,buy,1553,0.01,76.8440,,,AUDJPY
3083,2009.06.03 23:30,buy,1554,0.01,76.8430,,,AUDJPY
3084,2009.06.03 23:30,buy,1555,0.02,0.80105,,,AUDUSD
3085,2009.06.03 23:30,buy,1556,0.01,0.80101,,,AUDUSD
3086,2009.06.03 23:38,sell,1557,0.01,1.76675,,,EURAUD
3087,2009.06.03 23:39,buy,1558,0.01,1.26082,,,AUDNZD
3088,2009.06.03 23:41,buy,1559,0.01,0.85724,,,AUDCHF
3089,2009.06.03 23:42,buy,1560,0.01,0.89061,,,AUDCAD
3090,2009.06.03 23:42,buy,1561,0.01,76.7110,,,AUDJPY
3091,2009.06.03 23:42,sell,1562,0.01,2.03644,,,GBPAUD
3092,2009.06.03 23:43,buy,1563,0.01,0.79966,,,AUDUSD
3093,2009.06.04 14:25,sell,1564,0.01,2.04013,,,GBPAUD
3094,2009.06.04 14:29,buy,1565,0.01,0.88359,,,AUDCAD
3095,2009.06.04 14:29,buy,1566,0.01,0.85426,,,AUDCHF
3096,2009.06.04 14:29,buy,1567,0.01,77.0010,,,AUDJPY
3097,2009.06.04 14:29,buy,1568,0.01,1.26641,,,AUDNZD
3098,2009.06.04 14:29,sell,1569,0.01,1.77017,,,EURAUD
3099,2009.06.04 14:30,buy,1570,0.01,0.79602,,,AUDUSD
3100,2009.06.05 11:25,close,1569,0.01,1.76123,9.31,15777.64,EURAUD
3101,2009.06.05 11:25,close,1557,0.01,1.76123,6.08,15783.72,EURAUD
3102,2009.06.05 11:25,close,1539,0.01,1.76123,6.01,15789.73,EURAUD
3103,2009.06.05 11:25,close,1538,0.01,1.76123,5.99,15795.72,EURAUD
3104,2009.06.05 11:25,close,1537,0.01,1.76123,6.01,15801.73,EURAUD
3105,2009.06.05 11:25,close,1530,0.01,1.76123,-18.69,15783.04,EURAUD
3106,2009.06.05 11:28,close,1567,0.01,77.9330,9.47,15792.51,AUDJPY
3107,2009.06.05 11:28,close,1561,0.01,77.9330,12.61,15805.12,AUDJPY
3108,2009.06.05 11:28,close,1554,0.01,77.9330,11.28,15816.40,AUDJPY
3109,2009.06.05 11:28,close,1553,0.01,77.9330,11.27,15827.67,AUDJPY
3110,2009.06.05 11:28,close,1552,0.01,77.9330,11.26,15838.93,AUDJPY
3111,2009.06.05 11:28,close,1533,0.01,77.9330,-2.71,15836.22,AUDJPY
3112,2009.06.05 11:28,close,1568,0.01,1.26145,-4.24,15831.98,AUDNZD
3113,2009.06.05 11:28,close,1558,0.01,1.26145,0.52,15832.50,AUDNZD
3114,2009.06.05 11:28,close,1548,0.01,1.26145,0.23,15832.73,AUDNZD
3115,2009.06.05 11:28,close,1547,0.01,1.26145,0.26,15832.99,AUDNZD
3116,2009.06.05 11:28,close,1546,0.01,1.26145,0.25,15833.24,AUDNZD
3117,2009.06.05 11:28,close,1534,0.01,1.26145,-1.48,15831.76,AUDNZD
3118,2009.06.05 11:28,close,1564,0.01,1.99151,50.20,15881.96,GBPAUD
3119,2009.06.05 11:28,close,1562,0.01,1.99151,46.70,15928.66,GBPAUD
3120,2009.06.05 11:28,close,1551,0.01,1.99151,45.46,15974.12,GBPAUD
3121,2009.06.05 11:28,close,1550,0.01,1.99151,45.54,16019.66,GBPAUD
3122,2009.06.05 11:28,close,1549,0.01,1.99151,45.64,16065.30,GBPAUD
3123,2009.06.05 11:28,close,1535,0.01,1.99151,35.44,16100.74,GBPAUD
3124,2009.06.05 11:29,close,1565,0.01,0.88721,3.63,16104.37,AUDCAD
3125,2009.06.05 11:29,close,1560,0.01,0.88721,-3.20,16101.17,AUDCAD
3126,2009.06.05 11:29,close,1542,0.01,0.88721,-3.27,16097.90,AUDCAD
3127,2009.06.05 11:29,close,1541,0.01,0.88721,-3.25,16094.65,AUDCAD
3128,2009.06.05 11:29,close,1540,0.01,0.88721,-3.22,16091.43,AUDCAD
3129,2009.06.05 11:29,close,1531,0.01,0.88721,0.91,16092.34,AUDCAD
3130,2009.06.05 11:29,close,1566,0.01,0.86085,7.10,16099.44,AUDCHF
3131,2009.06.05 11:29,close,1559,0.01,0.86085,4.12,16103.56,AUDCHF
3132,2009.06.05 11:29,close,1545,0.01,0.86085,3.90,16107.46,AUDCHF
3133,2009.06.05 11:29,close,1544,0.01,0.86085,3.85,16111.31,AUDCHF
3134,2009.06.05 11:29,close,1543,0.01,0.86085,3.80,16115.11,AUDCHF
3135,2009.06.05 11:29,close,1532,0.01,0.86085,-10.20,16104.91,AUDCHF
3136,2009.06.05 11:30,close,1570,0.01,0.80507,9.12,16114.03,AUDUSD
3137,2009.06.05 11:30,close,1563,0.01,0.80507,5.67,16119.70,AUDUSD
3138,2009.06.05 11:30,close,1556,0.01,0.80507,4.32,16124.02,AUDUSD
3139,2009.06.05 11:30,close,1555,0.02,0.80507,8.56,16132.58,AUDUSD
3140,2009.06.05 11:30,close,1536,0.01,0.80507,-9.36,16123.22,AUDUSD
3141,2009.06.08 11:25,sell,1571,0.01,1.76257,,,EURAUD
3142,2009.06.08 11:29,buy,1572,0.01,0.86234,,,AUDCHF
3143,2009.06.08 11:29,buy,1573,0.01,77.5580,,,AUDJPY
3144,2009.06.08 11:29,sell,1574,0.01,2.01148,,,GBPAUD
3145,2009.06.08 11:30,buy,1575,0.01,0.88480,,,AUDCAD
3146,2009.06.08 11:30,buy,1576,0.01,1.26838,,,AUDNZD
3147,2009.06.08 11:30,buy,1577,0.01,0.78747,,,AUDUSD
3148,2009.06.08 11:32,sell,1578,0.01,1.76142,,,EURAUD
3149,2009.06.08 11:36,buy,1579,0.01,0.86116,,,AUDCHF
3150,2009.06.08 11:36,buy,1580,0.01,77.3560,,,AUDJPY
3151,2009.06.08 11:36,buy,1581,0.01,1.26910,,,AUDNZD
3152,2009.06.08 11:36,sell,1582,0.01,2.01486,,,GBPAUD
3153,2009.06.08 11:37,buy,1583,0.01,0.88420,,,AUDCAD
3154,2009.06.08 11:37,buy,1584,0.01,0.78517,,,AUDUSD
3155,2009.06.08 11:49,sell,1585,0.01,1.76183,,,EURAUD
3156,2009.06.08 11:54,buy,1586,0.01,0.88381,,,AUDCAD
3157,2009.06.08 11:54,buy,1587,0.01,0.86082,,,AUDCHF
3158,2009.06.08 11:54,buy,1588,0.01,77.2020,,,AUDJPY
3159,2009.06.08 11:54,buy,1589,0.01,1.26770,,,AUDNZD
3160,2009.06.08 11:54,buy,1590,0.01,0.78376,,,AUDUSD
3161,2009.06.08 11:54,sell,1591,0.01,2.01854,,,GBPAUD
3162,2009.06.08 18:55,sell,1592,0.01,1.76771,,,EURAUD
3163,2009.06.08 18:55,sell,1593,0.01,1.76770,,,EURAUD
3164,2009.06.08 18:56,buy,1594,0.01,1.27208,,,AUDNZD
3165,2009.06.08 18:56,buy,1595,0.01,1.27209,,,AUDNZD
3166,2009.06.08 18:58,sell,1596,0.01,2.03908,,,GBPAUD
3167,2009.06.08 18:58,sell,1597,0.01,2.03911,,,GBPAUD
3168,2009.06.08 18:59,buy,1598,0.01,0.85893,,,AUDCHF
3169,2009.06.08 18:59,buy,1599,0.01,0.85892,,,AUDCHF
3170,2009.06.08 19:00,buy,1600,0.01,0.88156,,,AUDCAD
3171,2009.06.08 19:00,buy,1601,0.01,0.88157,,,AUDCAD
3172,2009.06.08 19:00,buy,1602,0.01,77.3320,,,AUDJPY
3173,2009.06.08 19:00,buy,1603,0.01,77.3330,,,AUDJPY
3174,2009.06.08 19:00,buy,1604,0.01,0.78599,,,AUDUSD
3175,2009.06.08 19:00,buy,1605,0.01,0.78604,,,AUDUSD
3176,2009.06.09 20:25,close,1593,0.01,1.75140,16.90,16140.12,EURAUD
3177,2009.06.09 20:25,close,1592,0.01,1.75140,16.91,16157.03,EURAUD
3178,2009.06.09 20:25,close,1585,0.01,1.75140,10.85,16167.88,EURAUD
3179,2009.06.09 20:25,close,1578,0.01,1.75140,10.43,16178.31,EURAUD
3180,2009.06.09 20:25,close,1571,0.01,1.75140,11.61,16189.92,EURAUD
3181,2009.06.09 20:28,close,1595,0.01,1.27793,4.98,16194.90,AUDNZD
3182,2009.06.09 20:28,close,1594,0.01,1.27793,4.99,16199.89,AUDNZD
3183,2009.06.09 20:28,close,1589,0.01,1.27793,8.73,16208.62,AUDNZD
3184,2009.06.09 20:28,close,1581,0.01,1.27793,7.54,16216.16,AUDNZD
3185,2009.06.09 20:28,close,1576,0.01,1.27793,8.15,16224.31,AUDNZD
3186,2009.06.09 20:28,close,1597,0.01,2.03219,7.23,16231.54,GBPAUD
3187,2009.06.09 20:28,close,1596,0.01,2.03219,7.20,16238.74,GBPAUD
3188,2009.06.09 20:28,close,1591,0.01,2.03219,-13.97,16224.77,GBPAUD
3189,2009.06.09 20:28,close,1582,0.01,2.03219,-17.76,16207.01,GBPAUD
3190,2009.06.09 20:28,close,1574,0.01,2.03219,-21.24,16185.77,GBPAUD
3191,2009.06.09 20:29,close,1599,0.01,0.86547,7.06,16192.83,AUDCHF
3192,2009.06.09 20:29,close,1598,0.01,0.86547,7.05,16199.88,AUDCHF
3193,2009.06.09 20:29,close,1587,0.01,0.86547,5.03,16204.91,AUDCHF
3194,2009.06.09 20:29,close,1579,0.01,0.86547,4.67,16209.58,AUDCHF
3195,2009.06.09 20:29,close,1572,0.01,0.86547,3.40,16212.98,AUDCHF
3196,2009.06.09 20:29,close,1603,0.01,78.1610,8.42,16221.40,AUDJPY
3197,2009.06.09 20:29,close,1602,0.01,78.1610,8.43,16229.83,AUDJPY
3198,2009.06.09 20:29,close,1588,0.01,78.1610,9.74,16239.57,AUDJPY
3199,2009.06.09 20:29,close,1580,0.01,78.1610,8.19,16247.76,AUDJPY
3200,2009.06.09 20:29,close,1573,0.01,78.1610,6.15,16253.91,AUDJPY
3201,2009.06.09 20:30,close,1601,0.01,0.88319,1.64,16255.55,AUDCAD
3202,2009.06.09 20:30,close,1600,0.01,0.88319,1.65,16257.20,AUDCAD
3203,2009.06.09 20:30,close,1586,0.01,0.88319,-0.58,16256.62,AUDCAD
3204,2009.06.09 20:30,close,1583,0.01,0.88319,-0.96,16255.66,AUDCAD
3205,2009.06.09 20:30,close,1575,0.01,0.88319,-1.56,16254.10,AUDCAD
3206,2009.06.09 20:30,close,1605,0.01,0.80337,17.40,16271.50,AUDUSD
3207,2009.06.09 20:30,close,1604,0.01,0.80337,17.45,16288.95,AUDUSD
3208,2009.06.09 20:30,close,1590,0.01,0.80337,19.68,16308.63,AUDUSD
3209,2009.06.09 20:30,close,1584,0.01,0.80337,18.27,16326.90,AUDUSD
3210,2009.06.09 20:30,close,1577,0.01,0.80337,15.97,16342.87,AUDUSD
3211,2009.06.10 20:25,sell,1606,0.01,1.74402,,,EURAUD
3212,2009.06.10 20:29,buy,1607,0.01,0.86611,,,AUDCHF
3213,2009.06.10 20:29,sell,1608,0.01,2.03685,,,GBPAUD
3214,2009.06.10 20:30,buy,1609,0.01,0.88940,,,AUDCAD
3215,2009.06.10 20:30,buy,1610,0.01,78.5710,,,AUDJPY
3216,2009.06.10 20:30,buy,1611,0.01,1.27723,,,AUDNZD
3217,2009.06.10 20:30,buy,1612,0.01,0.79969,,,AUDUSD
3218,2009.06.11 04:59,close,1606,0.01,1.73142,13.27,16356.14,EURAUD
3219,2009.06.11 05:04,close,1609,0.01,0.89399,4.69,16360.83,AUDCAD
3220,2009.06.11 05:04,close,1607,0.01,0.87252,7.04,16367.87,AUDCHF
3221,2009.06.11 05:04,close,1610,0.01,79.3600,8.17,16376.04,AUDJPY
3222,2009.06.11 05:04,close,1611,0.01,1.27108,-5.26,16370.78,AUDNZD
3223,2009.06.11 05:04,close,1612,0.01,0.80976,10.27,16381.05,AUDUSD
3224,2009.06.11 05:04,close,1608,0.01,2.02478,12.74,16393.79,GBPAUD
3225,2009.06.12 06:25,sell,1613,0.01,1.72905,,,EURAUD
3226,2009.06.12 06:30,buy,1614,0.01,0.90227,,,AUDCAD
3227,2009.06.12 06:30,buy,1615,0.01,0.87322,,,AUDCHF
3228,2009.06.12 06:30,buy,1616,0.01,79.6620,,,AUDJPY
3229,2009.06.12 06:30,buy,1617,0.01,1.26538,,,AUDNZD
3230,2009.06.12 06:30,buy,1618,0.01,0.81423,,,AUDUSD
3231,2009.06.12 06:30,sell,1619,0.01,2.02995,,,GBPAUD
3232,2009.06.15 03:25,sell,1620,0.01,1.72930,,,EURAUD
3233,2009.06.15 03:29,buy,1621,0.01,0.87274,,,AUDCHF
3234,2009.06.15 03:29,buy,1622,0.01,1.26467,,,AUDNZD
3235,2009.06.15 03:29,sell,1623,0.01,2.03005,,,GBPAUD
3236,2009.06.15 03:30,buy,1624,0.01,0.90485,,,AUDCAD
3237,2009.06.15 03:30,buy,1625,0.01,79.3740,,,AUDJPY
3238,2009.06.15 03:30,buy,1626,0.01,0.80758,,,AUDUSD
3239,2009.06.15 09:05,sell,1627,0.01,1.72757,,,EURAUD
3240,2009.06.15 09:09,sell,1628,0.01,2.03352,,,GBPAUD
3241,2009.06.15 09:10,buy,1629,0.01,0.90411,,,AUDCAD
3242,2009.06.15 09:10,buy,1630,0.01,0.87454,,,AUDCHF
3243,2009.06.15 09:10,buy,1631,0.01,79.0110,,,AUDJPY
3244,2009.06.15 09:10,buy,1632,0.01,1.26356,,,AUDNZD
3245,2009.06.15 09:10,buy,1633,0.01,0.80386,,,AUDUSD
3246,2009.06.15 09:16,sell,1634,0.01,1.72987,,,EURAUD
3247,2009.06.15 09:20,sell,1635,0.01,2.03360,,,GBPAUD
3248,2009.06.15 09:21,buy,1636,0.01,0.90268,,,AUDCAD
3249,2009.06.15 09:21,buy,1637,0.01,0.87322,,,AUDCHF
3250,2009.06.15 09:21,buy,1638,0.01,78.8250,,,AUDJPY
3251,2009.06.15 09:21,buy,1639,0.01,1.26307,,,AUDNZD
3252,2009.06.15 09:21,buy,1640,0.01,0.80202,,,AUDUSD
3253,2009.06.15 10:39,sell,1641,0.01,1.73095,,,EURAUD
3254,2009.06.15 10:42,sell,1642,0.01,2.04163,,,GBPAUD
3255,2009.06.15 10:44,buy,1643,0.01,0.90538,,,AUDCAD
3256,2009.06.15 10:44,buy,1644,0.01,0.87305,,,AUDCHF
3257,2009.06.15 10:44,buy,1645,0.01,78.7330,,,AUDJPY
3258,2009.06.15 10:44,buy,1646,0.01,1.26168,,,AUDNZD
3259,2009.06.15 10:44,buy,1647,0.01,0.80157,,,AUDUSD
3260,2009.06.15 22:25,sell,1648,0.01,1.73451,,,EURAUD
3261,2009.06.15 22:25,sell,1649,0.01,1.73448,,,EURAUD
3262,2009.06.15 22:25,sell,1650,0.01,1.73445,,,EURAUD
3263,2009.06.15 22:26,sell,1651,0.01,2.05133,,,GBPAUD
3264,2009.06.15 22:26,sell,1652,0.01,2.05134,,,GBPAUD
3265,2009.06.15 22:26,sell,1653,0.01,2.05136,,,GBPAUD
3266,2009.06.15 22:29,buy,1654,0.01,0.90039,,,AUDCAD
3267,2009.06.15 22:29,buy,1655,0.01,0.90038,,,AUDCAD
3268,2009.06.15 22:29,buy,1656,0.01,0.90036,,,AUDCAD
3269,2009.06.15 22:29,buy,1657,0.01,0.86816,,,AUDCHF
3270,2009.06.15 22:29,buy,1658,0.01,0.86813,,,AUDCHF
3271,2009.06.15 22:29,buy,1659,0.01,0.86814,,,AUDCHF
3272,2009.06.15 22:30,buy,1660,0.01,77.7800,,,AUDJPY
3273,2009.06.15 22:30,buy,1661,0.01,77.7820,,,AUDJPY
3274,2009.06.15 22:30,buy,1662,0.01,77.7840,,,AUDJPY
3275,2009.06.15 22:30,buy,1663,0.01,1.25745,,,AUDNZD
3276,2009.06.15 22:30,buy,1664,0.01,1.25736,,,AUDNZD
3277,2009.06.15 22:30,buy,1665,0.01,1.25737,,,AUDNZD
3278,2009.06.15 22:30,buy,1666,0.02,0.79495,,,AUDUSD
3279,2009.06.15 22:30,buy,1667,0.01,0.79493,,,AUDUSD
3280,2009.06.16 00:55,sell,1668,0.01,1.73635,,,EURAUD
3281,2009.06.16 00:58,buy,1669,0.01,0.86714,,,AUDCHF
3282,2009.06.16 00:58,buy,1670,0.01,77.6570,,,AUDJPY
3283,2009.06.16 00:59,buy,1671,0.01,0.89882,,,AUDCAD
3284,2009.06.16 00:59,buy,1672,0.01,1.25970,,,AUDNZD
3285,2009.06.16 00:59,sell,1673,0.01,2.05194,,,GBPAUD
3286,2009.06.16 01:00,buy,1674,0.01,0.79372,,,AUDUSD
3287,2009.06.16 07:25,sell,1675,0.01,1.74300,,,EURAUD
3288,2009.06.16 07:25,sell,1676,0.01,1.74299,,,EURAUD
3289,2009.06.16 07:26,sell,1677,0.01,1.74425,,,EURAUD
3290,2009.06.16 07:26,sell,1678,0.01,2.05546,,,GBPAUD
3291,2009.06.16 07:26,sell,1679,0.01,2.05551,,,GBPAUD
3292,2009.06.16 07:28,buy,1680,0.01,0.86312,,,AUDCHF
3293,2009.06.16 07:28,buy,1681,0.01,0.86310,,,AUDCHF
3294,2009.06.16 07:28,buy,1682,0.01,76.3950,,,AUDJPY
3295,2009.06.16 07:28,buy,1683,0.01,76.3900,,,AUDJPY
3296,2009.06.16 07:28,sell,1684,0.01,2.05619,,,GBPAUD
3297,2009.06.16 07:29,buy,1685,0.01,0.89752,,,AUDCAD
3298,2009.06.16 07:29,buy,1686,0.01,0.89755,,,AUDCAD
3299,2009.06.16 07:29,buy,1687,0.01,1.25979,,,AUDNZD
3300,2009.06.16 07:29,buy,1688,0.01,1.25978,,,AUDNZD
3301,2009.06.16 07:30,buy,1689,0.01,0.86355,,,AUDCHF
3302,2009.06.16 07:30,buy,1690,0.01,76.5000,,,AUDJPY
3303,2009.06.16 07:30,buy,1691,0.01,0.79346,,,AUDUSD
3304,2009.06.16 07:30,buy,1692,0.01,0.79348,,,AUDUSD
3305,2009.06.16 07:31,buy,1693,0.01,0.89679,,,AUDCAD
3306,2009.06.16 07:31,buy,1694,0.01,1.25891,,,AUDNZD
3307,2009.06.16 07:31,buy,1695,0.01,0.79295,,,AUDUSD
3308,2009.06.17 02:25,sell,1696,0.01,1.74419,,,EURAUD
3309,2009.06.17 02:27,buy,1697,0.01,1.25779,,,AUDNZD
3310,2009.06.17 02:29,buy,1698,0.01,0.89902,,,AUDCAD
3311,2009.06.17 02:29,buy,1699,0.01,0.86272,,,AUDCHF
3312,2009.06.17 02:29,sell,1700,0.01,2.06528,,,GBPAUD
3313,2009.06.17 02:30,buy,1701,0.01,76.3930,,,AUDJPY
3314,2009.06.17 02:30,buy,1702,0.01,0.79244,,,AUDUSD
3315,2009.06.17 02:46,sell,1703,0.01,1.74690,,,EURAUD
3316,2009.06.17 02:51,buy,1704,0.01,0.89831,,,AUDCAD
3317,2009.06.17 02:51,buy,1705,0.01,0.86173,,,AUDCHF
3318,2009.06.17 02:51,buy,1706,0.01,76.3530,,,AUDJPY
3319,2009.06.17 02:51,buy,1707,0.01,1.25545,,,AUDNZD
3320,2009.06.17 02:51,buy,1708,0.01,0.79166,,,AUDUSD
3321,2009.06.17 02:51,sell,1709,0.01,2.06675,,,GBPAUD
3322,2009.06.17 17:25,sell,1710,0.01,1.75330,,,EURAUD
3323,2009.06.17 17:29,buy,1711,0.01,0.85806,,,AUDCHF
3324,2009.06.17 17:29,buy,1712,0.01,75.5180,,,AUDJPY
3325,2009.06.17 17:29,buy,1713,0.01,1.25541,,,AUDNZD
3326,2009.06.17 17:29,sell,1714,0.01,2.06295,,,GBPAUD
3327,2009.06.17 17:30,buy,1715,0.01,0.90004,,,AUDCAD
3328,2009.06.17 17:30,buy,1716,0.01,0.78989,,,AUDUSD
3329,2009.06.17 17:33,sell,1717,0.01,1.75498,,,EURAUD
3330,2009.06.17 17:37,sell,1718,0.01,2.06410,,,GBPAUD
3331,2009.06.17 17:38,buy,1719,0.01,0.89963,,,AUDCAD
3332,2009.06.17 17:38,buy,1720,0.01,0.85746,,,AUDCHF
3333,2009.06.17 17:38,buy,1721,0.01,75.4560,,,AUDJPY
3334,2009.06.17 17:38,buy,1722,0.01,1.25525,,,AUDNZD
3335,2009.06.17 17:38,buy,1723,0.01,0.78924,,,AUDUSD
3336,2009.06.17 17:45,sell,1724,0.01,1.75794,,,EURAUD
3337,2009.06.17 17:49,sell,1725,0.01,2.06531,,,GBPAUD
3338,2009.06.17 17:50,buy,1726,0.01,0.89768,,,AUDCAD
3339,2009.06.17 17:50,buy,1727,0.01,0.85664,,,AUDCHF
3340,2009.06.17 17:50,buy,1728,0.01,75.3660,,,AUDJPY
3341,2009.06.17 17:50,buy,1729,0.01,1.25474,,,AUDNZD
3342,2009.06.17 17:50,buy,1730,0.01,0.78801,,,AUDUSD
3343,2009.06.18 20:25,close,1725,0.01,2.03946,26.94,16420.73,GBPAUD
3344,2009.06.18 20:25,close,1718,0.01,2.03946,25.69,16446.42,GBPAUD
3345,2009.06.18 20:25,close,1714,0.01,2.03946,24.50,16470.92,GBPAUD
3346,2009.06.18 20:25,close,1709,0.01,2.03946,28.42,16499.34,GBPAUD
3347,2009.06.18 20:25,close,1700,0.01,2.03946,26.90,16526.24,GBPAUD
3348,2009.06.18 20:25,close,1684,0.01,2.03946,17.64,16543.88,GBPAUD
3349,2009.06.18 20:25,close,1679,0.01,2.03946,16.94,16560.82,GBPAUD
3350,2009.06.18 20:25,close,1678,0.01,2.03946,16.89,16577.71,GBPAUD
3351,2009.06.18 20:25,close,1673,0.01,2.03946,13.26,16590.97,GBPAUD
3352,2009.06.18 20:25,close,1653,0.01,2.03946,12.75,16603.72,GBPAUD
3353,2009.06.18 20:25,close,1652,0.01,2.03946,12.73,16616.45,GBPAUD
3354,2009.06.18 20:25,close,1651,0.01,2.03946,12.72,16629.17,GBPAUD
3355,2009.06.18 20:25,close,1642,0.01,2.03946,2.73,16631.90,GBPAUD
3356,2009.06.18 20:25,close,1635,0.01,2.03946,-5.55,16626.35,GBPAUD
3357,2009.06.18 20:25,close,1628,0.01,2.03946,-5.63,16620.72,GBPAUD
3358,2009.06.18 20:25,close,1623,0.01,2.03946,-9.21,16611.51,GBPAUD
3359,2009.06.18 20:25,close,1619,0.01,2.03946,-9.21,16602.30,GBPAUD
3360,2009.06.18 20:28,close,1724,0.01,1.73877,20.04,16622.34,EURAUD
3361,2009.06.18 20:28,close,1717,0.01,1.73877,16.99,16639.33,EURAUD
3362,2009.06.18 20:28,close,1710,0.01,1.73877,15.26,16654.59,EURAUD
3363,2009.06.18 20:28,close,1703,0.01,1.73877,8.67,16663.26,EURAUD
3364,2009.06.18 20:28,close,1696,0.01,1.73877,5.87,16669.13,EURAUD
3365,2009.06.18 20:28,close,1677,0.01,1.73877,6.04,16675.17,EURAUD
3366,2009.06.18 20:28,close,1676,0.01,1.73877,4.74,16679.91,EURAUD
3367,2009.06.18 20:28,close,1675,0.01,1.73877,4.75,16684.66,EURAUD
3368,2009.06.18 20:28,close,1668,0.01,1.73877,-2.10,16682.56,EURAUD
3369,2009.06.18 20:28,close,1650,0.01,1.73877,-3.96,16678.60,EURAUD
3370,2009.06.18 20:28,close,1649,0.01,1.73877,-3.93,16674.67,EURAUD
3371,2009.06.18 20:28,close,1648,0.01,1.73877,-3.90,16670.77,EURAUD
3372,2009.06.18 20:28,close,1641,0.01,1.73877,-7.57,16663.20,EURAUD
3373,2009.06.18 20:28,close,1634,0.01,1.73877,-8.68,16654.52,EURAUD
3374,2009.06.18 20:28,close,1627,0.01,1.73877,-11.05,16643.47,EURAUD
3375,2009.06.18 20:28,close,1620,0.01,1.73877,-9.27,16634.20,EURAUD
3376,2009.06.18 20:28,close,1613,0.01,1.73877,-9.43,16624.77,EURAUD
3377,2009.06.18 20:29,close,1727,0.01,0.86883,13.22,16637.99,AUDCHF
3378,2009.06.18 20:29,close,1720,0.01,0.86883,12.34,16650.33,AUDCHF
3379,2009.06.18 20:29,close,1711,0.01,0.86883,11.70,16662.03,AUDCHF
3380,2009.06.18 20:29,close,1705,0.01,0.86883,7.78,16669.81,AUDCHF
3381,2009.06.18 20:29,close,1699,0.01,0.86883,6.72,16676.53,AUDCHF
3382,2009.06.18 20:29,close,1689,0.01,0.86883,5.90,16682.43,AUDCHF
3383,2009.06.18 20:29,close,1681,0.01,0.86883,6.38,16688.81,AUDCHF
3384,2009.06.18 20:29,close,1680,0.01,0.86883,6.36,16695.17,AUDCHF
3385,2009.06.18 20:29,close,1669,0.01,0.86883,2.06,16697.23,AUDCHF
3386,2009.06.18 20:29,close,1659,0.01,0.86883,1.05,16698.28,AUDCHF
3387,2009.06.18 20:29,close,1658,0.01,0.86883,1.07,16699.35,AUDCHF
3388,2009.06.18 20:29,close,1657,0.01,0.86883,1.03,16700.38,AUDCHF
3389,2009.06.18 20:29,close,1644,0.01,0.86883,-4.19,16696.19,AUDCHF
3390,2009.06.18 20:29,close,1637,0.01,0.86883,-4.38,16691.81,AUDCHF
3391,2009.06.18 20:29,close,1630,0.01,0.86883,-5.79,16686.02,AUDCHF
3392,2009.06.18 20:29,close,1621,0.01,0.86883,-3.86,16682.16,AUDCHF
3393,2009.06.18 20:29,close,1615,0.01,0.86883,-4.31,16677.85,AUDCHF
3394,2009.06.18 20:29,close,1729,0.01,1.24990,-4.15,16673.70,AUDNZD
3395,2009.06.18 20:29,close,1722,0.01,1.24990,-4.58,16669.12,AUDNZD
3396,2009.06.18 20:29,close,1713,0.01,1.24990,-4.72,16664.40,AUDNZD
3397,2009.06.18 20:29,close,1707,0.01,1.24990,-4.75,16659.65,AUDNZD
3398,2009.06.18 20:29,close,1697,0.01,1.24990,-6.75,16652.90,AUDNZD
3399,2009.06.18 20:29,close,1694,0.01,1.24990,-7.71,16645.19,AUDNZD
3400,2009.06.18 20:29,close,1688,0.01,1.24990,-8.45,16636.74,AUDNZD
3401,2009.06.18 20:29,close,1687,0.01,1.24990,-8.46,16628.28,AUDNZD
3402,2009.06.18 20:29,close,1672,0.01,1.24990,-8.38,16619.90,AUDNZD
3403,2009.06.18 20:29,close,1665,0.01,1.24990,-6.39,16613.51,AUDNZD
3404,2009.06.18 20:29,close,1664,0.01,1.24990,-6.38,16607.13,AUDNZD
3405,2009.06.18 20:29,close,1663,0.01,1.24990,-6.46,16600.67,AUDNZD
3406,2009.06.18 20:29,close,1646,0.01,1.24990,-10.07,16590.60,AUDNZD
3407,2009.06.18 20:29,close,1639,0.01,1.24990,-11.26,16579.34,AUDNZD
3408,2009.06.18 20:29,close,1632,0.01,1.24990,-11.67,16567.67,AUDNZD
3409,2009.06.18 20:29,close,1622,0.01,1.24990,-12.62,16555.05,AUDNZD
3410,2009.06.18 20:29,close,1617,0.01,1.24990,-13.24,16541.81,AUDNZD
3411,2009.06.18 20:30,close,1726,0.01,0.90618,8.56,16550.37,AUDCAD
3412,2009.06.18 20:30,close,1719,0.01,0.90618,6.63,16557.00,AUDCAD
3413,2009.06.18 20:30,close,1715,0.01,0.90618,6.22,16563.22,AUDCAD
3414,2009.06.18 20:30,close,1704,0.01,0.90618,7.94,16571.16,AUDCAD
3415,2009.06.18 20:30,close,1698,0.01,0.90618,7.24,16578.40,AUDCAD
3416,2009.06.18 20:30,close,1693,0.01,0.90618,9.49,16587.89,AUDCAD
3417,2009.06.18 20:30,close,1686,0.01,0.90618,8.73,16596.62,AUDCAD
3418,2009.06.18 20:30,close,1685,0.01,0.90618,8.76,16605.38,AUDCAD
3419,2009.06.18 20:30,close,1671,0.01,0.90618,7.47,16612.85,AUDCAD
3420,2009.06.18 20:30,close,1656,0.01,0.90618,5.99,16618.84,AUDCAD
3421,2009.06.18 20:30,close,1655,0.01,0.90618,5.97,16624.81,AUDCAD
3422,2009.06.18 20:30,close,1654,0.01,0.90618,5.96,16630.77,AUDCAD
3423,2009.06.18 20:30,close,1643,0.01,0.90618,1.01,16631.78,AUDCAD
3424,2009.06.18 20:30,close,1636,0.01,0.90618,3.69,16635.47,AUDCAD
3425,2009.06.18 20:30,close,1629,0.01,0.90618,2.27,16637.74,AUDCAD
3426,2009.06.18 20:30,close,1624,0.01,0.90618,1.53,16639.27,AUDCAD
3427,2009.06.18 20:30,close,1614,0.01,0.90618,4.14,16643.41,AUDCAD
3428,2009.06.18 20:30,close,1728,0.01,77.1670,18.38,16661.79,AUDJPY
3429,2009.06.18 20:30,close,1721,0.01,77.1670,17.47,16679.26,AUDJPY
3430,2009.06.18 20:30,close,1712,0.01,77.1670,16.85,16696.11,AUDJPY
3431,2009.06.18 20:30,close,1706,0.01,77.1670,8.43,16704.54,AUDJPY
3432,2009.06.18 20:30,close,1701,0.01,77.1670,8.02,16712.56,AUDJPY
3433,2009.06.18 20:30,close,1690,0.01,77.1670,7.01,16719.57,AUDJPY
3434,2009.06.18 20:30,close,1683,0.01,77.1670,8.12,16727.69,AUDJPY
3435,2009.06.18 20:30,close,1682,0.01,77.1670,8.07,16735.76,AUDJPY
3436,2009.06.18 20:30,close,1670,0.01,77.1670,-4.66,16731.10,AUDJPY
3437,2009.06.18 20:30,close,1662,0.01,77.1670,-5.87,16725.23,AUDJPY
3438,2009.06.18 20:30,close,1661,0.01,77.1670,-5.85,16719.38,AUDJPY
3439,2009.06.18 20:30,close,1660,0.01,77.1670,-5.83,16713.55,AUDJPY
3440,2009.06.18 20:30,close,1645,0.01,77.1670,-15.44,16698.11,AUDJPY
3441,2009.06.18 20:30,close,1638,0.01,77.1670,-16.37,16681.74,AUDJPY
3442,2009.06.18 20:30,close,1631,0.01,77.1670,-18.24,16663.50,AUDJPY
3443,2009.06.18 20:30,close,1625,0.01,77.1670,-21.91,16641.59,AUDJPY
3444,2009.06.18 20:30,close,1616,0.01,77.1670,-24.73,16616.86,AUDJPY
3445,2009.06.18 20:30,close,1730,0.01,0.79946,11.65,16628.51,AUDUSD
3446,2009.06.18 20:30,close,1723,0.01,0.79946,10.42,16638.93,AUDUSD
3447,2009.06.18 20:30,close,1716,0.01,0.79946,9.77,16648.70,AUDUSD
3448,2009.06.18 20:30,close,1708,0.01,0.79946,8.00,16656.70,AUDUSD
3449,2009.06.18 20:30,close,1702,0.01,0.79946,7.21,16663.91,AUDUSD
3450,2009.06.18 20:30,close,1695,0.01,0.79946,6.77,16670.68,AUDUSD
3451,2009.06.18 20:30,close,1692,0.01,0.79946,6.24,16676.92,AUDUSD
3452,2009.06.18 20:30,close,1691,0.01,0.79946,6.26,16683.18,AUDUSD
3453,2009.06.18 20:30,close,1674,0.01,0.79946,6.00,16689.18,AUDUSD
3454,2009.06.18 20:30,close,1667,0.01,0.79946,4.86,16694.04,AUDUSD
3455,2009.06.18 20:30,close,1666,0.02,0.79946,9.67,16703.71,AUDUSD
3456,2009.06.18 20:30,close,1647,0.01,0.79946,-1.78,16701.93,AUDUSD
3457,2009.06.18 20:30,close,1640,0.01,0.79946,-2.23,16699.70,AUDUSD
3458,2009.06.18 20:30,close,1633,0.01,0.79946,-4.08,16695.62,AUDUSD
3459,2009.06.18 20:30,close,1626,0.01,0.79946,-7.79,16687.83,AUDUSD
3460,2009.06.18 20:30,close,1618,0.01,0.79946,-14.38,16673.45,AUDUSD
3461,2009.06.22 04:25,sell,1731,0.01,1.73643,,,EURAUD
3462,2009.06.22 04:30,buy,1732,0.01,0.91037,,,AUDCAD
3463,2009.06.22 04:30,buy,1733,0.01,0.86728,,,AUDCHF
3464,2009.06.22 04:30,buy,1734,0.01,76.8710,,,AUDJPY
3465,2009.06.22 04:30,buy,1735,0.01,1.25182,,,AUDNZD
3466,2009.06.22 04:30,buy,1736,0.01,0.80097,,,AUDUSD
3467,2009.06.22 04:30,sell,1737,0.01,2.05507,,,GBPAUD
3468,2009.06.22 11:49,sell,1738,0.01,1.73725,,,EURAUD
3469,2009.06.22 11:52,sell,1739,0.01,2.06489,,,GBPAUD
3470,2009.06.22 11:54,buy,1740,0.01,0.91108,,,AUDCAD
3471,2009.06.22 11:54,buy,1741,0.01,0.86718,,,AUDCHF
3472,2009.06.22 11:54,buy,1742,0.01,76.5400,,,AUDJPY
3473,2009.06.22 11:54,buy,1743,0.01,1.25362,,,AUDNZD
3474,2009.06.22 11:54,buy,1744,0.01,0.79770,,,AUDUSD
3475,2009.06.22 12:03,sell,1745,0.01,1.73748,,,EURAUD
3476,2009.06.22 12:07,sell,1746,0.01,2.06588,,,GBPAUD
3477,2009.06.22 12:08,buy,1747,0.01,0.91053,,,AUDCAD
3478,2009.06.22 12:08,buy,1748,0.01,0.86650,,,AUDCHF
3479,2009.06.22 12:08,buy,1749,0.01,76.3960,,,AUDJPY
3480,2009.06.22 12:08,buy,1750,0.01,1.25338,,,AUDNZD
3481,2009.06.22 12:08,buy,1751,0.01,0.79647,,,AUDUSD
3482,2009.06.22 14:12,sell,1752,0.01,1.74122,,,EURAUD
3483,2009.06.22 14:15,sell,1753,0.01,2.06779,,,GBPAUD
3484,2009.06.22 14:17,buy,1754,0.01,0.91125,,,AUDCAD
3485,2009.06.22 14:17,buy,1755,0.01,0.86525,,,AUDCHF
3486,2009.06.22 14:17,buy,1756,0.01,76.3120,,,AUDJPY
3487,2009.06.22 14:17,buy,1757,0.01,1.25253,,,AUDNZD
3488,2009.06.22 14:17,buy,1758,0.01,0.79513,,,AUDUSD
3489,2009.06.23 09:25,sell,1759,0.01,2.07870,,,GBPAUD
3490,2009.06.23 09:25,sell,1760,0.01,2.07867,,,GBPAUD
3491,2009.06.23 09:25,sell,1761,0.01,2.07864,,,GBPAUD
3492,2009.06.23 09:25,sell,1762,0.01,2.07861,,,GBPAUD
3493,2009.06.23 09:25,sell,1763,0.01,2.07858,,,GBPAUD
3494,2009.06.23 09:25,sell,1764,0.01,2.07856,,,GBPAUD
3495,2009.06.23 09:26,sell,1765,0.01,1.76994,,,EURAUD
3496,2009.06.23 09:26,sell,1766,0.01,1.76999,,,EURAUD
3497,2009.06.23 09:26,sell,1767,0.01,1.77003,,,EURAUD
3498,2009.06.23 09:26,sell,1768,0.01,1.77008,,,EURAUD
3499,2009.06.23 09:26,sell,1769,0.01,1.77012,,,EURAUD
3500,2009.06.23 09:26,sell,1770,0.01,1.77017,,,EURAUD
3501,2009.06.23 09:27,buy,1771,0.01,1.24290,,,AUDNZD
3502,2009.06.23 09:27,buy,1772,0.01,1.24292,,,AUDNZD
3503,2009.06.23 09:27,buy,1773,0.01,1.24295,,,AUDNZD
3504,2009.06.23 09:27,buy,1774,0.01,1.24297,,,AUDNZD
3505,2009.06.23 09:27,buy,1775,0.01,1.24299,,,AUDNZD
3506,2009.06.23 09:27,buy,1776,0.01,1.24301,,,AUDNZD
3507,2009.06.23 09:29,buy,1777,0.01,0.90485,,,AUDCAD
3508,2009.06.23 09:29,buy,1778,0.01,0.90486,,,AUDCAD
3509,2009.06.23 09:29,buy,1779,0.01,0.90484,,,AUDCAD
3510,2009.06.23 09:29,buy,1780,0.01,0.90482,,,AUDCAD
3511,2009.06.23 09:29,buy,1781,0.01,0.90480,,,AUDCAD
3512,2009.06.23 09:29,buy,1782,0.01,0.90478,,,AUDCAD
3513,2009.06.23 09:29,buy,1783,0.01,0.85061,,,AUDCHF
3514,2009.06.23 09:29,buy,1784,0.01,0.85060,,,AUDCHF
3515,2009.06.23 09:29,buy,1785,0.01,0.85061,,,AUDCHF
3516,2009.06.23 09:29,buy,1786,0.01,0.85060,,,AUDCHF
3517,2009.06.23 09:29,buy,1787,0.01,0.85059,,,AUDCHF
3518,2009.06.23 09:29,buy,1788,0.01,0.85057,,,AUDCHF
3519,2009.06.23 09:29,buy,1789,0.01,74.7640,,,AUDJPY
3520,2009.06.23 09:29,buy,1790,0.01,74.7650,,,AUDJPY
3521,2009.06.23 09:29,buy,1791,0.01,74.7630,,,AUDJPY
3522,2009.06.23 09:29,buy,1792,0.01,74.7600,,,AUDJPY
3523,2009.06.23 09:29,buy,1793,0.01,74.7580,,,AUDJPY
3524,2009.06.23 09:29,buy,1794,0.01,74.7550,,,AUDJPY
3525,2009.06.23 09:30,buy,1795,0.04,0.78478,,,AUDUSD
3526,2009.06.23 09:30,buy,1796,0.01,0.78479,,,AUDUSD
3527,2009.06.23 09:30,buy,1797,0.01,0.78478,,,AUDUSD
3528,2009.06.23 09:50,sell,1798,0.01,2.07796,,,GBPAUD
3529,2009.06.23 09:54,sell,1799,0.01,1.77131,,,EURAUD
3530,2009.06.23 09:55,buy,1800,0.01,0.90371,,,AUDCAD
3531,2009.06.23 09:55,buy,1801,0.01,0.84836,,,AUDCHF
3532,2009.06.23 09:55,buy,1802,0.01,74.6280,,,AUDJPY
3533,2009.06.23 09:55,buy,1803,0.01,1.24023,,,AUDNZD
3534,2009.06.23 09:55,buy,1804,0.01,0.78371,,,AUDUSD
3535,2009.06.24 09:25,close,1799,0.01,1.76825,3.26,16676.71,EURAUD
3536,2009.06.24 09:25,close,1770,0.01,1.76825,2.08,16678.79,EURAUD
3537,2009.06.24 09:25,close,1769,0.01,1.76825,2.03,16680.82,EURAUD
3538,2009.06.24 09:25,close,1768,0.01,1.76825,1.99,16682.81,EURAUD
3539,2009.06.24 09:25,close,1767,0.01,1.76825,1.94,16684.75,EURAUD
3540,2009.06.24 09:25,close,1766,0.01,1.76825,1.90,16686.65,EURAUD
3541,2009.06.24 09:25,close,1765,0.01,1.76825,1.85,16688.50,EURAUD
3542,2009.06.24 09:25,close,1752,0.01,1.76825,-27.65,16660.85,EURAUD
3543,2009.06.24 09:25,close,1745,0.01,1.76825,-31.50,16629.35,EURAUD
3544,2009.06.24 09:25,close,1738,0.01,1.76825,-31.74,16597.61,EURAUD
3545,2009.06.24 09:25,close,1731,0.01,1.76825,-32.58,16565.03,EURAUD
3546,2009.06.24 09:29,close,1801,0.01,0.84907,0.82,16565.85,AUDCHF
3547,2009.06.24 09:29,close,1788,0.01,0.84907,-1.54,16564.31,AUDCHF
3548,2009.06.24 09:29,close,1787,0.01,0.84907,-1.57,16562.74,AUDCHF
3549,2009.06.24 09:29,close,1786,0.01,0.84907,-1.58,16561.16,AUDCHF
3550,2009.06.24 09:29,close,1785,0.01,0.84907,-1.59,16559.57,AUDCHF
3551,2009.06.24 09:29,close,1784,0.01,0.84907,-1.58,16557.99,AUDCHF
3552,2009.06.24 09:29,close,1783,0.01,0.84907,-1.59,16556.40,AUDCHF
3553,2009.06.24 09:29,close,1755,0.01,0.84907,-17.17,16539.23,AUDCHF
3554,2009.06.24 09:29,close,1748,0.01,0.84907,-18.50,16520.73,AUDCHF
3555,2009.06.24 09:29,close,1741,0.01,0.84907,-19.23,16501.50,AUDCHF
3556,2009.06.24 09:29,close,1733,0.01,0.84907,-19.34,16482.16,AUDCHF
3557,2009.06.24 09:30,close,1800,0.01,0.91439,10.63,16492.79,AUDCAD
3558,2009.06.24 09:30,close,1782,0.01,0.91439,9.57,16502.36,AUDCAD
3559,2009.06.24 09:30,close,1781,0.01,0.91439,9.55,16511.91,AUDCAD
3560,2009.06.24 09:30,close,1780,0.01,0.91439,9.53,16521.44,AUDCAD
3561,2009.06.24 09:30,close,1779,0.01,0.91439,9.51,16530.95,AUDCAD
3562,2009.06.24 09:30,close,1778,0.01,0.91439,9.49,16540.44,AUDCAD
3563,2009.06.24 09:30,close,1777,0.01,0.91439,9.50,16549.94,AUDCAD
3564,2009.06.24 09:30,close,1754,0.01,0.91439,3.20,16553.14,AUDCAD
3565,2009.06.24 09:30,close,1747,0.01,0.91439,3.92,16557.06,AUDCAD
3566,2009.06.24 09:30,close,1740,0.01,0.91439,3.37,16560.43,AUDCAD
3567,2009.06.24 09:30,close,1732,0.01,0.91439,4.08,16564.51,AUDCAD
3568,2009.06.24 09:30,close,1802,0.01,76.1170,15.08,16579.59,AUDJPY
3569,2009.06.24 09:30,close,1794,0.01,76.1170,13.80,16593.39,AUDJPY
3570,2009.06.24 09:30,close,1793,0.01,76.1170,13.77,16607.16,AUDJPY
3571,2009.06.24 09:30,close,1792,0.01,76.1170,13.75,16620.91,AUDJPY
3572,2009.06.24 09:30,close,1791,0.01,76.1170,13.72,16634.63,AUDJPY
3573,2009.06.24 09:30,close,1790,0.01,76.1170,13.70,16648.33,AUDJPY
3574,2009.06.24 09:30,close,1789,0.01,76.1170,13.71,16662.04,AUDJPY
3575,2009.06.24 09:30,close,1756,0.01,76.1170,-1.82,16660.22,AUDJPY
3576,2009.06.24 09:30,close,1749,0.01,76.1170,-2.67,16657.55,AUDJPY
3577,2009.06.24 09:30,close,1742,0.01,76.1170,-4.12,16653.43,AUDJPY
3578,2009.06.24 09:30,close,1734,0.01,76.1170,-7.46,16645.97,AUDJPY
3579,2009.06.24 09:30,close,1803,0.01,1.23844,-1.53,16644.44,AUDNZD
3580,2009.06.24 09:30,close,1776,0.01,1.23844,-3.90,16640.54,AUDNZD
3581,2009.06.24 09:30,close,1775,0.01,1.23844,-3.89,16636.65,AUDNZD
3582,2009.06.24 09:30,close,1774,0.01,1.23844,-3.87,16632.78,AUDNZD
3583,2009.06.24 09:30,close,1773,0.01,1.23844,-3.85,16628.93,AUDNZD
3584,2009.06.24 09:30,close,1772,0.01,1.23844,-3.83,16625.10,AUDNZD
3585,2009.06.24 09:30,close,1771,0.01,1.23844,-3.81,16621.29,AUDNZD
3586,2009.06.24 09:30,close,1757,0.01,1.23844,-12.04,16609.25,AUDNZD
3587,2009.06.24 09:30,close,1750,0.01,1.23844,-12.77,16596.48,AUDNZD
3588,2009.06.24 09:30,close,1743,0.01,1.23844,-12.97,16583.51,AUDNZD
3589,2009.06.24 09:30,close,1735,0.01,1.23844,-11.43,16572.08,AUDNZD
3590,2009.06.24 09:30,close,1804,0.01,0.79840,14.75,16586.83,AUDUSD
3591,2009.06.24 09:30,close,1797,0.01,0.79840,13.68,16600.51,AUDUSD
3592,2009.06.24 09:30,close,1796,0.01,0.79840,13.67,16614.18,AUDUSD
3593,2009.06.24 09:30,close,1795,0.04,0.79840,54.74,16668.92,AUDUSD
3594,2009.06.24 09:30,close,1758,0.01,0.79840,3.40,16672.32,AUDUSD
3595,2009.06.24 09:30,close,1751,0.01,0.79840,2.06,16674.38,AUDUSD
3596,2009.06.24 09:30,close,1744,0.01,0.79840,0.83,16675.21,AUDUSD
3597,2009.06.24 09:30,close,1736,0.01,0.79840,-2.44,16672.77,AUDUSD
3598,2009.06.24 09:30,close,1798,0.01,2.06984,8.47,16681.24,GBPAUD
3599,2009.06.24 09:30,close,1764,0.01,2.06984,9.09,16690.33,GBPAUD
3600,2009.06.24 09:30,close,1763,0.01,2.06984,9.11,16699.44,GBPAUD
3601,2009.06.24 09:30,close,1762,0.01,2.06984,9.14,16708.58,GBPAUD
3602,2009.06.24 09:30,close,1761,0.01,2.06984,9.17,16717.75,GBPAUD
3603,2009.06.24 09:30,close,1760,0.01,2.06984,9.20,16726.95,GBPAUD
3604,2009.06.24 09:30,close,1759,0.01,2.06984,9.23,16736.18,GBPAUD
3605,2009.06.24 09:30,close,1753,0.01,2.06984,-1.91,16734.27,GBPAUD
3606,2009.06.24 09:30,close,1746,0.01,2.06984,-3.88,16730.39,GBPAUD
3607,2009.06.24 09:30,close,1739,0.01,2.06984,-4.90,16725.49,GBPAUD
3608,2009.06.24 09:30,close,1737,0.01,2.06984,-15.02,16710.47,GBPAUD
3609,2009.06.29 04:25,sell,1805,0.01,1.74687,,,EURAUD
3610,2009.06.29 04:29,buy,1806,0.01,76.5480,,,AUDJPY
3611,2009.06.29 04:30,buy,1807,0.01,0.92776,,,AUDCAD
3612,2009.06.29 04:30,buy,1808,0.01,0.87196,,,AUDCHF
3613,2009.06.29 04:30,buy,1809,0.01,1.24544,,,AUDNZD
3614,2009.06.29 04:30,buy,1810,0.01,0.80282,,,AUDUSD
3615,2009.06.29 04:30,sell,1811,0.01,2.05061,,,GBPAUD
3616,2009.06.29 08:55,sell,1812,0.01,1.75013,,,EURAUD
3617,2009.06.29 08:59,buy,1813,0.01,0.87158,,,AUDCHF
3618,2009.06.29 08:59,buy,1814,0.01,1.24360,,,AUDNZD
3619,2009.06.29 09:00,buy,1815,0.01,0.92630,,,AUDCAD
3620,2009.06.29 09:00,buy,1816,0.01,76.4830,,,AUDJPY
3621,2009.06.29 09:00,buy,1817,0.01,0.80091,,,AUDUSD
3622,2009.06.29 09:00,sell,1818,0.01,2.05436,,,GBPAUD
3623,2009.06.29 20:26,close,1812,0.01,1.74158,8.81,16719.28,EURAUD
3624,2009.06.29 20:26,close,1805,0.01,1.74158,5.45,16724.73,EURAUD
3625,2009.06.29 20:30,close,1818,0.01,2.04766,6.90,16731.63,GBPAUD
3626,2009.06.29 20:30,close,1811,0.01,2.04766,3.04,16734.67,GBPAUD
3627,2009.06.29 20:31,close,1815,0.01,0.93435,7.99,16742.66,AUDCAD
3628,2009.06.29 20:31,close,1807,0.01,0.93435,6.54,16749.20,AUDCAD
3629,2009.06.29 20:31,close,1813,0.01,0.87376,2.33,16751.53,AUDCHF
3630,2009.06.29 20:31,close,1808,0.01,0.87376,1.92,16753.45,AUDCHF
3631,2009.06.29 20:31,close,1816,0.01,77.5800,11.06,16764.51,AUDJPY
3632,2009.06.29 20:31,close,1806,0.01,77.5800,10.41,16774.92,AUDJPY
3633,2009.06.29 20:31,close,1814,0.01,1.23979,-3.25,16771.67,AUDNZD
3634,2009.06.29 20:31,close,1809,0.01,1.23979,-4.82,16766.85,AUDNZD
3635,2009.06.29 20:31,close,1817,0.01,0.80773,6.82,16773.67,AUDUSD
3636,2009.06.29 20:31,close,1810,0.01,0.80773,4.91,16778.58,AUDUSD
3637,2009.07.02 08:27,sell,1819,0.01,1.75332,,,EURAUD
3638,2009.07.02 08:32,buy,1820,0.01,0.92429,,,AUDCAD
3639,2009.07.02 08:32,buy,1821,0.01,0.86708,,,AUDCHF
3640,2009.07.02 08:32,buy,1822,0.01,77.7820,,,AUDJPY
3641,2009.07.02 08:32,buy,1823,0.01,1.25814,,,AUDNZD
3642,2009.07.02 08:32,buy,1824,0.01,0.80508,,,AUDUSD
3643,2009.07.02 08:32,sell,1825,0.01,2.04396,,,GBPAUD
3644,2009.07.02 23:25,sell,1826,0.01,1.76008,,,EURAUD
3645,2009.07.02 23:25,sell,1827,0.01,1.76004,,,EURAUD
3646,2009.07.02 23:25,sell,1828,0.01,1.76001,,,EURAUD
3647,2009.07.02 23:27,buy,1829,0.01,0.86332,,,AUDCHF
3648,2009.07.02 23:27,buy,1830,0.01,0.86328,,,AUDCHF
3649,2009.07.02 23:27,buy,1831,0.01,0.86324,,,AUDCHF
3650,2009.07.02 23:30,buy,1832,0.01,0.92244,,,AUDCAD
3651,2009.07.02 23:30,buy,1833,0.01,0.92243,,,AUDCAD
3652,2009.07.02 23:30,buy,1834,0.01,0.92246,,,AUDCAD
3653,2009.07.02 23:30,buy,1835,0.01,76.0140,,,AUDJPY
3654,2009.07.02 23:30,buy,1836,0.01,76.0090,,,AUDJPY
3655,2009.07.02 23:30,buy,1837,0.01,76.0110,,,AUDJPY
3656,2009.07.02 23:30,buy,1838,0.01,1.26182,,,AUDNZD
3657,2009.07.02 23:30,buy,1839,0.01,1.26177,,,AUDNZD
3658,2009.07.02 23:30,buy,1840,0.01,1.26180,,,AUDNZD
3659,2009.07.02 23:30,buy,1841,0.02,0.79274,,,AUDUSD
3660,2009.07.02 23:30,buy,1842,0.01,0.79271,,,AUDUSD
3661,2009.07.02 23:31,sell,1843,0.01,2.06260,,,GBPAUD
3662,2009.07.02 23:31,sell,1844,0.01,2.06196,,,GBPAUD
3663,2009.07.02 23:31,sell,1845,0.01,2.06212,,,GBPAUD
3664,2009.07.03 09:25,close,1828,0.01,1.75452,5.75,16784.33,EURAUD
3665,2009.07.03 09:25,close,1827,0.01,1.75452,5.79,16790.12,EURAUD
3666,2009.07.03 09:25,close,1826,0.01,1.75452,5.83,16795.95,EURAUD
3667,2009.07.03 09:25,close,1819,0.01,1.75452,-1.14,16794.81,EURAUD
3668,2009.07.03 09:29,close,1831,0.01,0.86561,2.59,16797.40,AUDCHF
3669,2009.07.03 09:29,close,1830,0.01,0.86561,2.55,16799.95,AUDCHF
3670,2009.07.03 09:29,close,1829,0.01,0.86561,2.51,16802.46,AUDCHF
3671,2009.07.03 09:29,close,1821,0.01,0.86561,-1.51,16800.95,AUDCHF
3672,2009.07.03 09:30,close,1834,0.01,0.92506,2.62,16803.57,AUDCAD
3673,2009.07.03 09:30,close,1833,0.01,0.92506,2.65,16806.22,AUDCAD
3674,2009.07.03 09:30,close,1832,0.01,0.92506,2.64,16808.86,AUDCAD
3675,2009.07.03 09:30,close,1820,0.01,0.92506,0.80,16809.66,AUDCAD
3676,2009.07.03 09:30,close,1837,0.01,76.6210,6.23,16815.89,AUDJPY
3677,2009.07.03 09:30,close,1836,0.01,76.6210,6.25,16822.14,AUDJPY
3678,2009.07.03 09:30,close,1835,0.01,76.6210,6.19,16828.33,AUDJPY
3679,2009.07.03 09:30,close,1822,0.01,76.6210,-11.64,16816.69,AUDJPY
3680,2009.07.03 09:30,close,1840,0.01,1.26038,-1.21,16815.48,AUDNZD
3681,2009.07.03 09:30,close,1839,0.01,1.26038,-1.19,16814.29,AUDNZD
3682,2009.07.03 09:30,close,1838,0.01,1.26038,-1.23,16813.06,AUDNZD
3683,2009.07.03 09:30,close,1823,0.01,1.26038,1.91,16814.97,AUDNZD
3684,2009.07.03 09:30,close,1842,0.01,0.79874,6.10,16821.07,AUDUSD
3685,2009.07.03 09:30,close,1841,0.02,0.79874,12.13,16833.20,AUDUSD
3686,2009.07.03 09:30,close,1824,0.01,0.79874,-6.27,16826.93,AUDUSD
3687,2009.07.03 09:30,close,1845,0.01,2.05332,9.17,16836.10,GBPAUD
3688,2009.07.03 09:30,close,1844,0.01,2.05332,9.00,16845.10,GBPAUD
3689,2009.07.03 09:30,close,1843,0.01,2.05332,9.66,16854.76,GBPAUD
3690,2009.07.03 09:30,close,1825,0.01,2.05332,-9.54,16845.22,GBPAUD
3691,2009.07.06 01:25,sell,1846,0.01,1.75605,,,EURAUD
3692,2009.07.06 01:29,buy,1847,0.01,0.86449,,,AUDCHF
3693,2009.07.06 01:30,buy,1848,0.01,0.92343,,,AUDCAD
3694,2009.07.06 01:30,buy,1849,0.01,76.1820,,,AUDJPY
3695,2009.07.06 01:30,buy,1850,0.01,1.26396,,,AUDNZD
3696,2009.07.06 01:30,buy,1851,0.01,0.79466,,,AUDUSD
3697,2009.07.06 01:30,sell,1852,0.01,2.05063,,,GBPAUD
3698,2009.07.06 05:55,sell,1853,0.01,1.75917,,,EURAUD
3699,2009.07.06 05:59,buy,1854,0.01,0.86297,,,AUDCHF
3700,2009.07.06 05:59,buy,1855,0.01,75.7310,,,AUDJPY
3701,2009.07.06 06:00,buy,1856,0.01,0.92207,,,AUDCAD
3702,2009.07.06 06:00,buy,1857,0.01,1.26553,,,AUDNZD
3703,2009.07.06 06:00,buy,1858,0.01,0.79378,,,AUDUSD
3704,2009.07.06 06:00,sell,1859,0.01,2.05020,,,GBPAUD
3705,2009.07.06 10:25,sell,1860,0.01,1.76211,,,EURAUD
3706,2009.07.06 10:29,buy,1861,0.01,0.92212,,,AUDCAD
3707,2009.07.06 10:29,sell,1862,0.01,2.04044,,,GBPAUD
3708,2009.07.06 10:30,buy,1863,0.01,0.86202,,,AUDCHF
3709,2009.07.06 10:30,buy,1864,0.01,75.2380,,,AUDJPY
3710,2009.07.06 10:30,buy,1865,0.01,1.26004,,,AUDNZD
3711,2009.07.06 10:30,buy,1866,0.01,0.78940,,,AUDUSD
3712,2009.07.07 15:25,close,1860,0.01,1.75029,12.28,16857.50,EURAUD
3713,2009.07.07 15:25,close,1853,0.01,1.75029,9.25,16866.75,EURAUD
3714,2009.07.07 15:25,close,1846,0.01,1.75029,6.03,16872.78,EURAUD
3715,2009.07.07 15:29,close,1861,0.01,0.92623,4.11,16876.89,AUDCAD
3716,2009.07.07 15:29,close,1856,0.01,0.92623,4.16,16881.05,AUDCAD
3717,2009.07.07 15:29,close,1848,0.01,0.92623,2.81,16883.86,AUDCAD
3718,2009.07.07 15:29,close,1863,0.01,0.86706,5.45,16889.31,AUDCHF
3719,2009.07.07 15:29,close,1854,0.01,0.86706,4.43,16893.74,AUDCHF
3720,2009.07.07 15:29,close,1847,0.01,0.86706,2.81,16896.55,AUDCHF
3721,2009.07.07 15:29,close,1864,0.01,76.1040,8.80,16905.35,AUDJPY
3722,2009.07.07 15:29,close,1855,0.01,76.1040,3.83,16909.18,AUDJPY
3723,2009.07.07 15:29,close,1849,0.01,76.1040,-0.72,16908.46,AUDJPY
3724,2009.07.07 15:29,close,1865,0.01,1.25613,-3.34,16905.12,AUDNZD
3725,2009.07.07 15:29,close,1857,0.01,1.25613,-8.03,16897.09,AUDNZD
3726,2009.07.07 15:29,close,1850,0.01,1.25613,-6.69,16890.40,AUDNZD
3727,2009.07.07 15:30,close,1866,0.01,0.79945,10.12,16900.52,AUDUSD
3728,2009.07.07 15:30,close,1858,0.01,0.79945,5.74,16906.26,AUDUSD
3729,2009.07.07 15:30,close,1851,0.01,0.79945,4.86,16911.12,AUDUSD
3730,2009.07.07 15:30,close,1862,0.01,2.02493,16.08,16927.20,GBPAUD
3731,2009.07.07 15:30,close,1859,0.01,2.02493,26.14,16953.34,GBPAUD
3732,2009.07.07 15:30,close,1852,0.01,2.02493,26.58,16979.92,GBPAUD
3733,2009.07.08 08:55,sell,1867,0.01,1.76722,,,EURAUD
3734,2009.07.08 08:59,buy,1868,0.01,74.1180,,,AUDJPY
3735,2009.07.08 08:59,buy,1869,0.01,1.25177,,,AUDNZD
3736,2009.07.08 08:59,sell,1870,0.01,2.04677,,,GBPAUD
3737,2009.07.08 09:00,buy,1871,0.01,0.91555,,,AUDCAD
3738,2009.07.08 09:00,buy,1872,0.01,0.85868,,,AUDCHF
3739,2009.07.08 09:00,buy,1873,0.01,0.78642,,,AUDUSD
3740,2009.07.08 14:54,sell,1874,0.01,1.76974,,,EURAUD
3741,2009.07.08 14:59,buy,1875,0.01,0.91403,,,AUDCAD
3742,2009.07.08 14:59,buy,1876,0.01,0.85708,,,AUDCHF
3743,2009.07.08 14:59,buy,1877,0.01,73.9560,,,AUDJPY
3744,2009.07.08 14:59,buy,1878,0.01,1.25174,,,AUDNZD
3745,2009.07.08 14:59,buy,1879,0.01,0.78544,,,AUDUSD
3746,2009.07.08 14:59,sell,1880,0.01,2.04674,,,GBPAUD
3747,2009.07.08 22:25,sell,1881,0.01,1.78249,,,EURAUD
3748,2009.07.08 22:25,sell,1882,0.01,1.78255,,,EURAUD
3749,2009.07.08 22:25,sell,1883,0.01,1.78261,,,EURAUD
3750,2009.07.08 22:25,sell,1884,0.01,1.78260,,,EURAUD
3751,2009.07.08 22:28,sell,1885,0.01,2.06339,,,GBPAUD
3752,2009.07.08 22:28,sell,1886,0.01,2.06348,,,GBPAUD
3753,2009.07.08 22:28,sell,1887,0.01,2.06358,,,GBPAUD
3754,2009.07.08 22:28,sell,1888,0.01,2.06355,,,GBPAUD
3755,2009.07.08 22:29,buy,1889,0.01,0.90771,,,AUDCAD
3756,2009.07.08 22:29,buy,1890,0.01,0.90772,,,AUDCAD
3757,2009.07.08 22:29,buy,1891,0.01,0.90770,,,AUDCAD
3758,2009.07.08 22:29,buy,1892,0.01,0.90769,,,AUDCAD
3759,2009.07.08 22:29,buy,1893,0.01,0.84831,,,AUDCHF
3760,2009.07.08 22:29,buy,1894,0.01,0.84830,,,AUDCHF
3761,2009.07.08 22:29,buy,1895,0.01,0.84829,,,AUDCHF
3762,2009.07.08 22:29,buy,1896,0.01,0.84833,,,AUDCHF
3763,2009.07.08 22:29,buy,1897,0.01,72.1570,,,AUDJPY
3764,2009.07.08 22:29,buy,1898,0.01,72.1580,,,AUDJPY
3765,2009.07.08 22:29,buy,1899,0.01,72.1600,,,AUDJPY
3766,2009.07.08 22:29,buy,1900,0.01,72.1610,,,AUDJPY
3767,2009.07.08 22:29,buy,1901,0.01,1.24279,,,AUDNZD
3768,2009.07.08 22:29,buy,1902,0.01,1.24285,,,AUDNZD
3769,2009.07.08 22:29,buy,1903,0.01,1.24292,,,AUDNZD
3770,2009.07.08 22:29,buy,1904,0.01,1.24298,,,AUDNZD
3771,2009.07.08 22:30,buy,1905,0.03,0.77821,,,AUDUSD
3772,2009.07.08 22:30,buy,1906,0.01,0.77819,,,AUDUSD
3773,2009.07.09 02:07,sell,1907,0.01,1.78297,,,EURAUD
3774,2009.07.09 02:10,buy,1908,0.01,72.1030,,,AUDJPY
3775,2009.07.09 02:12,buy,1909,0.01,0.90464,,,AUDCAD
3776,2009.07.09 02:12,buy,1910,0.01,0.84796,,,AUDCHF
3777,2009.07.09 02:12,buy,1911,0.01,1.24234,,,AUDNZD
3778,2009.07.09 02:12,buy,1912,0.01,0.77692,,,AUDUSD
3779,2009.07.09 02:12,sell,1913,0.01,2.06397,,,GBPAUD
3780,2009.07.10 04:55,sell,1914,0.01,1.78803,,,EURAUD
3781,2009.07.10 05:00,buy,1915,0.01,0.90741,,,AUDCAD
3782,2009.07.10 05:00,buy,1916,0.01,0.84549,,,AUDCHF
3783,2009.07.10 05:00,buy,1917,0.01,72.5530,,,AUDJPY
3784,2009.07.10 05:00,buy,1918,0.01,1.23953,,,AUDNZD
3785,2009.07.10 05:00,buy,1919,0.01,0.78129,,,AUDUSD
3786,2009.07.10 05:00,sell,1920,0.01,2.08349,,,GBPAUD
3787,2009.07.10 12:55,sell,1921,0.01,1.79078,,,EURAUD
3788,2009.07.10 12:55,sell,1922,0.01,1.79081,,,EURAUD
3789,2009.07.10 12:59,buy,1923,0.01,0.90447,,,AUDCAD
3790,2009.07.10 12:59,buy,1924,0.01,71.9880,,,AUDJPY
3791,2009.07.10 13:00,buy,1925,0.01,0.90400,,,AUDCAD
3792,2009.07.10 13:00,buy,1926,0.01,0.84723,,,AUDCHF
3793,2009.07.10 13:00,buy,1927,0.01,0.84726,,,AUDCHF
3794,2009.07.10 13:00,buy,1928,0.01,71.9920,,,AUDJPY
3795,2009.07.10 13:00,buy,1929,0.01,1.23876,,,AUDNZD
3796,2009.07.10 13:00,buy,1930,0.01,1.23866,,,AUDNZD
3797,2009.07.10 13:00,buy,1931,0.01,0.77637,,,AUDUSD
3798,2009.07.10 13:00,buy,1932,0.01,0.77645,,,AUDUSD
3799,2009.07.10 13:00,sell,1933,0.01,2.08569,,,GBPAUD
3800,2009.07.10 13:00,sell,1934,0.01,2.08551,,,GBPAUD
3801,2009.07.10 13:17,sell,1935,0.01,1.79042,,,EURAUD
3802,2009.07.10 13:21,buy,1936,0.01,0.84620,,,AUDCHF
3803,2009.07.10 13:21,buy,1937,0.01,1.23909,,,AUDNZD
3804,2009.07.10 13:21,sell,1938,0.01,2.08833,,,GBPAUD
3805,2009.07.10 13:22,buy,1939,0.01,0.90327,,,AUDCAD
3806,2009.07.10 13:22,buy,1940,0.01,71.8300,,,AUDJPY
3807,2009.07.10 13:22,buy,1941,0.01,0.77559,,,AUDUSD
3808,2009.07.10 17:55,sell,1942,0.01,1.79475,,,EURAUD
3809,2009.07.10 17:59,buy,1943,0.01,0.90300,,,AUDCAD
3810,2009.07.10 17:59,buy,1944,0.01,0.84143,,,AUDCHF
3811,2009.07.10 17:59,buy,1945,0.01,71.5470,,,AUDJPY
3812,2009.07.10 17:59,buy,1946,0.01,1.23875,,,AUDNZD
3813,2009.07.10 17:59,sell,1947,0.01,2.08797,,,GBPAUD
3814,2009.07.10 18:00,buy,1948,0.01,0.77510,,,AUDUSD
3815,2009.07.13 12:25,sell,1949,0.01,1.80515,,,EURAUD
3816,2009.07.13 12:27,sell,1950,0.01,2.07852,,,GBPAUD
3817,2009.07.13 12:28,buy,1951,0.01,0.83848,,,AUDCHF
3818,2009.07.13 12:29,buy,1952,0.01,0.89947,,,AUDCAD
3819,2009.07.13 12:29,buy,1953,0.01,71.2620,,,AUDJPY
3820,2009.07.13 12:29,buy,1954,0.01,1.24279,,,AUDNZD
3821,2009.07.13 12:30,buy,1955,0.01,0.77315,,,AUDUSD
3822,2009.07.14 00:26,close,1949,0.01,1.78401,21.89,17001.81,EURAUD
3823,2009.07.14 00:26,close,1942,0.01,1.78401,11.27,17013.08,EURAUD
3824,2009.07.14 00:26,close,1935,0.01,1.78401,6.81,17019.89,EURAUD
3825,2009.07.14 00:26,close,1922,0.01,1.78401,7.21,17027.10,EURAUD
3826,2009.07.14 00:26,close,1921,0.01,1.78401,7.18,17034.28,EURAUD
3827,2009.07.14 00:26,close,1914,0.01,1.78401,4.35,17038.63,EURAUD
3828,2009.07.14 00:26,close,1907,0.01,1.78401,-0.78,17037.85,EURAUD
3829,2009.07.14 00:26,close,1884,0.01,1.78401,-0.86,17036.99,EURAUD
3830,2009.07.14 00:26,close,1883,0.01,1.78401,-0.85,17036.14,EURAUD
3831,2009.07.14 00:26,close,1882,0.01,1.78401,-0.91,17035.23,EURAUD
3832,2009.07.14 00:26,close,1881,0.01,1.78401,-0.97,17034.26,EURAUD
3833,2009.07.14 00:26,close,1874,0.01,1.78401,-14.11,17020.15,EURAUD
3834,2009.07.14 00:26,close,1867,0.01,1.78401,-16.71,17003.44,EURAUD
3835,2009.07.14 00:27,close,1952,0.01,0.90199,2.54,17005.98,AUDCAD
3836,2009.07.14 00:27,close,1943,0.01,0.90199,-0.91,17005.07,AUDCAD
3837,2009.07.14 00:27,close,1939,0.01,0.90199,-1.18,17003.89,AUDCAD
3838,2009.07.14 00:27,close,1925,0.01,0.90199,-1.90,17001.99,AUDCAD
3839,2009.07.14 00:27,close,1923,0.01,0.90199,-2.37,16999.62,AUDCAD
3840,2009.07.14 00:27,close,1915,0.01,0.90199,-5.29,16994.33,AUDCAD
3841,2009.07.14 00:27,close,1909,0.01,0.90199,-2.50,16991.83,AUDCAD
3842,2009.07.14 00:27,close,1892,0.01,0.90199,-5.39,16986.44,AUDCAD
3843,2009.07.14 00:27,close,1891,0.01,0.90199,-5.40,16981.04,AUDCAD
3844,2009.07.14 00:27,close,1890,0.01,0.90199,-5.42,16975.62,AUDCAD
3845,2009.07.14 00:27,close,1889,0.01,0.90199,-5.41,16970.21,AUDCAD
3846,2009.07.14 00:27,close,1875,0.01,0.90199,-11.68,16958.53,AUDCAD
3847,2009.07.14 00:27,close,1871,0.01,0.90199,-13.19,16945.34,AUDCAD
3848,2009.07.14 00:27,close,1951,0.01,0.84799,10.23,16955.57,AUDCHF
3849,2009.07.14 00:27,close,1944,0.01,0.84799,7.15,16962.72,AUDCHF
3850,2009.07.14 00:27,close,1936,0.01,0.84799,2.05,16964.77,AUDCHF
3851,2009.07.14 00:27,close,1927,0.01,0.84799,0.91,16965.68,AUDCHF
3852,2009.07.14 00:27,close,1926,0.01,0.84799,0.95,16966.63,AUDCHF
3853,2009.07.14 00:27,close,1916,0.01,0.84799,2.81,16969.44,AUDCHF
3854,2009.07.14 00:27,close,1910,0.01,0.84799,0.23,16969.67,AUDCHF
3855,2009.07.14 00:27,close,1896,0.01,0.84799,0.03,16969.70,AUDCHF
3856,2009.07.14 00:27,close,1895,0.01,0.84799,0.07,16969.77,AUDCHF
3857,2009.07.14 00:27,close,1894,0.01,0.84799,0.06,16969.83,AUDCHF
3858,2009.07.14 00:27,close,1893,0.01,0.84799,0.05,16969.88,AUDCHF
3859,2009.07.14 00:27,close,1876,0.01,0.84799,-9.32,16960.56,AUDCHF
3860,2009.07.14 00:27,close,1872,0.01,0.84799,-11.03,16949.53,AUDCHF
3861,2009.07.14 00:27,close,1953,0.01,72.9210,16.80,16966.33,AUDJPY
3862,2009.07.14 00:27,close,1945,0.01,72.9210,14.01,16980.34,AUDJPY
3863,2009.07.14 00:27,close,1940,0.01,72.9210,11.16,16991.50,AUDJPY
3864,2009.07.14 00:27,close,1928,0.01,72.9210,9.52,17001.02,AUDJPY
3865,2009.07.14 00:27,close,1924,0.01,72.9210,9.56,17010.58,AUDJPY
3866,2009.07.14 00:27,close,1917,0.01,72.9210,3.86,17014.44,AUDJPY
3867,2009.07.14 00:27,close,1908,0.01,72.9210,8.47,17022.91,AUDJPY
3868,2009.07.14 00:27,close,1900,0.01,72.9210,8.11,17031.02,AUDJPY
3869,2009.07.14 00:27,close,1899,0.01,72.9210,8.12,17039.14,AUDJPY
3870,2009.07.14 00:27,close,1898,0.01,72.9210,8.14,17047.28,AUDJPY
3871,2009.07.14 00:27,close,1897,0.01,72.9210,8.15,17055.43,AUDJPY
3872,2009.07.14 00:27,close,1877,0.01,72.9210,-10.00,17045.43,AUDJPY
3873,2009.07.14 00:27,close,1868,0.01,72.9210,-11.63,17033.80,AUDJPY
3874,2009.07.14 00:27,close,1954,0.01,1.23419,-7.34,17026.46,AUDNZD
3875,2009.07.14 00:27,close,1946,0.01,1.23419,-3.90,17022.56,AUDNZD
3876,2009.07.14 00:27,close,1937,0.01,1.23419,-4.19,17018.37,AUDNZD
3877,2009.07.14 00:27,close,1930,0.01,1.23419,-3.82,17014.55,AUDNZD
3878,2009.07.14 00:27,close,1929,0.01,1.23419,-3.91,17010.64,AUDNZD
3879,2009.07.14 00:27,close,1918,0.01,1.23419,-4.56,17006.08,AUDNZD
3880,2009.07.14 00:27,close,1911,0.01,1.23419,-6.96,16999.12,AUDNZD
3881,2009.07.14 00:27,close,1904,0.01,1.23419,-7.52,16991.60,AUDNZD
3882,2009.07.14 00:27,close,1903,0.01,1.23419,-7.47,16984.13,AUDNZD
3883,2009.07.14 00:27,close,1902,0.01,1.23419,-7.41,16976.72,AUDNZD
3884,2009.07.14 00:27,close,1901,0.01,1.23419,-7.36,16969.36,AUDNZD
3885,2009.07.14 00:27,close,1878,0.01,1.23419,-15.00,16954.36,AUDNZD
3886,2009.07.14 00:27,close,1869,0.01,1.23419,-15.02,16939.34,AUDNZD
3887,2009.07.14 00:27,close,1950,0.01,2.07173,7.10,16946.44,GBPAUD
3888,2009.07.14 00:27,close,1947,0.01,2.07173,16.93,16963.37,GBPAUD
3889,2009.07.14 00:27,close,1938,0.01,2.07173,17.31,16980.68,GBPAUD
3890,2009.07.14 00:27,close,1934,0.01,2.07173,14.40,16995.08,GBPAUD
3891,2009.07.14 00:27,close,1933,0.01,2.07173,14.58,17009.66,GBPAUD
3892,2009.07.14 00:27,close,1920,0.01,2.07173,12.32,17021.98,GBPAUD
3893,2009.07.14 00:27,close,1913,0.01,2.07173,-7.70,17014.28,GBPAUD
3894,2009.07.14 00:27,close,1888,0.01,2.07173,-7.84,17006.44,GBPAUD
3895,2009.07.14 00:27,close,1887,0.01,2.07173,-7.81,16998.63,GBPAUD
3896,2009.07.14 00:27,close,1886,0.01,2.07173,-7.91,16990.72,GBPAUD
3897,2009.07.14 00:27,close,1885,0.01,2.07173,-8.00,16982.72,GBPAUD
3898,2009.07.14 00:27,close,1880,0.01,2.07173,-25.16,16957.56,GBPAUD
3899,2009.07.14 00:27,close,1870,0.01,2.07173,-25.13,16932.43,GBPAUD
3900,2009.07.14 00:30,close,1955,0.01,0.78379,10.71,16943.14,AUDUSD
3901,2009.07.14 00:30,close,1948,0.01,0.78379,8.82,16951.96,AUDUSD
3902,2009.07.14 00:30,close,1941,0.01,0.78379,8.33,16960.29,AUDUSD
3903,2009.07.14 00:30,close,1932,0.01,0.78379,7.47,16967.76,AUDUSD
3904,2009.07.14 00:30,close,1931,0.01,0.78379,7.55,16975.31,AUDUSD
3905,2009.07.14 00:30,close,1919,0.01,0.78379,2.63,16977.94,AUDUSD
3906,2009.07.14 00:30,close,1912,0.01,0.78379,7.07,16985.01,AUDUSD
3907,2009.07.14 00:30,close,1906,0.01,0.78379,5.99,16991.00,AUDUSD
3908,2009.07.14 00:30,close,1905,0.03,0.78379,17.91,17008.91,AUDUSD
3909,2009.07.14 00:30,close,1879,0.01,0.78379,-1.26,17007.65,AUDUSD
3910,2009.07.14 00:30,close,1873,0.01,0.78379,-2.24,17005.41,AUDUSD
3911,2009.07.17 04:25,sell,1956,0.01,1.76288,,,EURAUD
3912,2009.07.17 04:29,buy,1957,0.01,74.9360,,,AUDJPY
3913,2009.07.17 04:29,buy,1958,0.01,1.24152,,,AUDNZD
3914,2009.07.17 04:29,sell,1959,0.01,2.04594,,,GBPAUD
3915,2009.07.17 04:30,buy,1960,0.01,0.89590,,,AUDCAD
3916,2009.07.17 04:30,buy,1961,0.01,0.86123,,,AUDCHF
3917,2009.07.17 04:30,buy,1962,0.01,0.80070,,,AUDUSD
3918,2009.07.17 06:55,sell,1963,0.01,1.76517,,,EURAUD
3919,2009.07.17 06:58,buy,1964,0.01,0.89432,,,AUDCAD
3920,2009.07.17 06:58,buy,1965,0.01,0.86061,,,AUDCHF
3921,2009.07.17 06:58,buy,1966,0.01,74.9350,,,AUDJPY
3922,2009.07.17 06:58,buy,1967,0.01,1.24074,,,AUDNZD
3923,2009.07.17 06:58,sell,1968,0.01,2.04782,,,GBPAUD
3924,2009.07.17 07:00,buy,1969,0.01,0.80001,,,AUDUSD
3925,2009.07.20 03:25,close,1963,0.01,1.75602,9.53,17014.94,EURAUD
3926,2009.07.20 03:25,close,1956,0.01,1.75602,7.17,17022.11,EURAUD
3927,2009.07.20 03:29,close,1965,0.01,0.86441,4.12,17026.23,AUDCHF
3928,2009.07.20 03:29,close,1961,0.01,0.86441,3.46,17029.69,AUDCHF
3929,2009.07.20 03:30,close,1964,0.01,0.89431,0.03,17029.72,AUDCAD
3930,2009.07.20 03:30,close,1960,0.01,0.89431,-1.54,17028.18,AUDCAD
3931,2009.07.20 03:30,close,1966,0.01,76.1250,12.07,17040.25,AUDJPY
3932,2009.07.20 03:30,close,1957,0.01,76.1250,12.06,17052.31,AUDJPY
3933,2009.07.20 03:30,close,1967,0.01,1.24271,1.68,17053.99,AUDNZD
3934,2009.07.20 03:30,close,1958,0.01,1.24271,1.02,17055.01,AUDNZD
3935,2009.07.20 03:30,close,1969,0.01,0.80578,5.84,17060.85,AUDUSD
3936,2009.07.20 03:30,close,1962,0.01,0.80578,5.15,17066.00,AUDUSD
3937,2009.07.20 03:30,close,1968,0.01,2.03239,16.00,17082.00,GBPAUD
3938,2009.07.20 03:30,close,1959,0.01,2.03239,14.07,17096.07,GBPAUD
3939,2009.07.22 15:55,sell,1970,0.01,1.74351,,,EURAUD
3940,2009.07.22 15:59,buy,1971,0.01,0.86947,,,AUDCHF
3941,2009.07.22 15:59,buy,1972,0.01,76.1130,,,AUDJPY
3942,2009.07.22 15:59,sell,1973,0.01,2.01462,,,GBPAUD
3943,2009.07.22 16:00,buy,1974,0.01,0.89466,,,AUDCAD
3944,2009.07.22 16:00,buy,1975,0.01,1.24047,,,AUDNZD
3945,2009.07.22 16:00,buy,1976,0.01,0.81313,,,AUDUSD
3946,2009.07.23 10:28,close,1970,0.01,1.73670,7.30,17103.37,EURAUD
3947,2009.07.23 10:31,close,1973,0.01,2.01666,-1.81,17101.56,GBPAUD
3948,2009.07.23 10:32,close,1971,0.01,0.87471,5.79,17107.35,AUDCHF
3949,2009.07.23 10:32,close,1972,0.01,77.3220,12.42,17119.77,AUDJPY
3950,2009.07.23 10:32,close,1975,0.01,1.23994,-0.47,17119.30,AUDNZD
3951,2009.07.23 10:33,close,1974,0.01,0.90054,5.96,17125.26,AUDCAD
3952,2009.07.23 10:33,close,1976,0.01,0.81881,5.88,17131.14,AUDUSD
3953,2009.07.23 23:25,sell,1977,0.01,1.74100,,,EURAUD
3954,2009.07.23 23:29,buy,1978,0.01,0.88640,,,AUDCAD
3955,2009.07.23 23:29,buy,1979,0.01,0.87352,,,AUDCHF
3956,2009.07.23 23:29,buy,1980,0.01,1.24175,,,AUDNZD
3957,2009.07.23 23:29,sell,1981,0.01,2.02607,,,GBPAUD
3958,2009.07.23 23:30,buy,1982,0.01,77.1990,,,AUDJPY
3959,2009.07.23 23:30,buy,1983,0.01,0.81322,,,AUDUSD
3960,2009.07.27 03:57,close,1977,0.01,1.73689,4.44,17135.58,EURAUD
3961,2009.07.27 04:01,close,1980,0.01,1.24660,4.13,17139.71,AUDNZD
3962,2009.07.27 04:02,close,1978,0.01,0.88769,1.37,17141.08,AUDCAD
3963,2009.07.27 04:02,close,1979,0.01,0.87615,2.94,17144.02,AUDCHF
3964,2009.07.27 04:02,close,1982,0.01,77.4900,3.08,17147.10,AUDJPY
3965,2009.07.27 04:02,close,1983,0.01,0.81797,4.88,17151.98,AUDUSD
3966,2009.07.27 04:02,close,1981,0.01,2.00838,18.43,17170.41,GBPAUD
3967,2009.07.29 06:25,sell,1984,0.01,1.71611,,,EURAUD
3968,2009.07.29 06:29,buy,1985,0.01,0.89343,,,AUDCAD
3969,2009.07.29 06:29,buy,1986,0.01,0.88742,,,AUDCHF
3970,2009.07.29 06:29,buy,1987,0.01,77.9150,,,AUDJPY
3971,2009.07.29 06:29,buy,1988,0.01,1.25392,,,AUDNZD
3972,2009.07.29 06:30,buy,1989,0.01,0.82582,,,AUDUSD
3973,2009.07.29 06:30,sell,1990,0.01,1.99102,,,GBPAUD
3974,2009.07.29 10:55,sell,1991,0.01,1.72414,,,EURAUD
3975,2009.07.29 10:55,sell,1992,0.01,1.72416,,,EURAUD
3976,2009.07.29 10:59,buy,1993,0.01,0.89087,,,AUDCAD
3977,2009.07.29 10:59,buy,1994,0.01,0.88319,,,AUDCHF
3978,2009.07.29 10:59,buy,1995,0.01,0.88318,,,AUDCHF
3979,2009.07.29 10:59,sell,1996,0.01,1.99479,,,GBPAUD
3980,2009.07.29 11:00,buy,1997,0.01,0.89083,,,AUDCAD
3981,2009.07.29 11:00,buy,1998,0.01,77.6490,,,AUDJPY
3982,2009.07.29 11:00,buy,1999,0.01,77.6480,,,AUDJPY
3983,2009.07.29 11:00,buy,2000,0.01,1.24929,,,AUDNZD
3984,2009.07.29 11:00,buy,2001,0.01,1.24930,,,AUDNZD
3985,2009.07.29 11:00,buy,2002,0.01,0.82046,,,AUDUSD
3986,2009.07.29 11:00,buy,2003,0.01,0.82043,,,AUDUSD
3987,2009.07.29 11:00,sell,2004,0.01,1.99487,,,GBPAUD
3988,2009.07.29 21:25,sell,2005,0.01,1.72026,,,EURAUD
3989,2009.07.29 21:25,sell,2006,0.01,1.72063,,,EURAUD
3990,2009.07.29 21:30,buy,2007,0.01,0.88932,,,AUDCAD
3991,2009.07.29 21:30,buy,2008,0.01,0.88932,,,AUDCAD
3992,2009.07.29 21:30,buy,2009,0.01,0.88672,,,AUDCHF
3993,2009.07.29 21:30,buy,2010,0.01,0.88679,,,AUDCHF
3994,2009.07.29 21:30,buy,2011,0.01,77.4160,,,AUDJPY
3995,2009.07.29 21:30,buy,2012,0.01,77.4170,,,AUDJPY
3996,2009.07.29 21:30,buy,2013,0.01,1.24385,,,AUDNZD
3997,2009.07.29 21:30,buy,2014,0.01,1.24378,,,AUDNZD
3998,2009.07.29 21:30,buy,2015,0.01,0.81520,,,AUDUSD
3999,2009.07.29 21:30,buy,2016,0.01,0.81508,,,AUDUSD
4000,2009.07.29 21:30,sell,2017,0.01,2.00780,,,GBPAUD
4001,2009.07.29 21:30,sell,2018,0.01,2.00804,,,GBPAUD
4002,2009.07.30 10:26,close,2006,0.01,1.71135,9.85,17180.26,EURAUD
4003,2009.07.30 10:26,close,2005,0.01,1.71135,9.47,17189.73,EURAUD
4004,2009.07.30 10:26,close,1992,0.01,1.71135,13.48,17203.21,EURAUD
4005,2009.07.30 10:26,close,1991,0.01,1.71135,13.46,17216.67,EURAUD
4006,2009.07.30 10:26,close,1984,0.01,1.71135,5.19,17221.86,EURAUD
4007,2009.07.30 10:31,close,2008,0.01,0.89183,2.62,17224.48,AUDCAD
4008,2009.07.30 10:31,close,2007,0.01,0.89183,2.62,17227.10,AUDCAD
4009,2009.07.30 10:31,close,1997,0.01,0.89183,1.12,17228.22,AUDCAD
4010,2009.07.30 10:31,close,1993,0.01,0.89183,1.08,17229.30,AUDCAD
4011,2009.07.30 10:31,close,1985,0.01,0.89183,-1.46,17227.84,AUDCAD
4012,2009.07.30 10:31,close,2010,0.01,0.89268,6.49,17234.33,AUDCHF
4013,2009.07.30 10:31,close,2009,0.01,0.89268,6.56,17240.89,AUDCHF
4014,2009.07.30 10:31,close,1995,0.01,0.89268,10.35,17251.24,AUDCHF
4015,2009.07.30 10:31,close,1994,0.01,0.89268,10.34,17261.58,AUDCHF
4016,2009.07.30 10:31,close,1986,0.01,0.89268,5.81,17267.39,AUDCHF
4017,2009.07.30 10:31,close,2012,0.01,77.9490,5.58,17272.97,AUDJPY
4018,2009.07.30 10:31,close,2011,0.01,77.9490,5.59,17278.56,AUDJPY
4019,2009.07.30 10:31,close,1999,0.01,77.9490,3.25,17281.81,AUDJPY
4020,2009.07.30 10:31,close,1998,0.01,77.9490,3.24,17285.05,AUDJPY
4021,2009.07.30 10:31,close,1987,0.01,77.9490,0.56,17285.61,AUDJPY
4022,2009.07.30 10:31,close,2014,0.01,1.25589,10.33,17295.94,AUDNZD
4023,2009.07.30 10:31,close,2013,0.01,1.25589,10.27,17306.21,AUDNZD
4024,2009.07.30 10:31,close,2001,0.01,1.25589,5.62,17311.83,AUDNZD
4025,2009.07.30 10:31,close,2000,0.01,1.25589,5.63,17317.46,AUDNZD
4026,2009.07.30 10:31,close,1988,0.01,1.25589,1.67,17319.13,AUDNZD
4027,2009.07.30 10:31,close,2016,0.01,0.82012,5.24,17324.37,AUDUSD
4028,2009.07.30 10:31,close,2015,0.01,0.82012,5.12,17329.49,AUDUSD
4029,2009.07.30 10:31,close,2003,0.01,0.82012,-0.11,17329.38,AUDUSD
4030,2009.07.30 10:31,close,2002,0.01,0.82012,-0.15,17329.23,AUDUSD
4031,2009.07.30 10:31,close,1989,0.01,0.82012,-5.50,17323.73,AUDUSD
4032,2009.07.30 10:31,close,2018,0.01,2.00799,0.35,17324.08,GBPAUD
4033,2009.07.30 10:31,close,2017,0.01,2.00799,0.11,17324.19,GBPAUD
4034,2009.07.30 10:31,close,2004,0.01,2.00799,-13.22,17310.97,GBPAUD
4035,2009.07.30 10:31,close,1996,0.01,2.00799,-13.30,17297.67,GBPAUD
4036,2009.07.30 10:31,close,1990,0.01,2.00799,-17.18,17280.49,GBPAUD
4037,2009.08.04 11:34,sell,2019,0.01,1.71220,,,EURAUD
4038,2009.08.04 11:37,buy,2020,0.01,0.89392,,,AUDCHF
4039,2009.08.04 11:39,buy,2021,0.01,0.89671,,,AUDCAD
4040,2009.08.04 11:39,buy,2022,0.01,79.5870,,,AUDJPY
4041,2009.08.04 11:39,buy,2023,0.01,1.26029,,,AUDNZD
4042,2009.08.04 11:39,buy,2024,0.01,0.84050,,,AUDUSD
4043,2009.08.04 11:39,sell,2025,0.01,2.01488,,,GBPAUD
4044,2009.08.05 19:25,sell,2026,0.01,1.71453,,,EURAUD
4045,2009.08.05 19:28,buy,2027,0.01,0.89241,,,AUDCHF
4046,2009.08.05 19:28,buy,2028,0.01,79.8120,,,AUDJPY
4047,2009.08.05 19:28,sell,2029,0.01,2.02315,,,GBPAUD
4048,2009.08.05 19:29,buy,2030,0.01,0.89969,,,AUDCAD
4049,2009.08.05 19:29,buy,2031,0.01,1.24754,,,AUDNZD
4050,2009.08.05 19:30,buy,2032,0.01,0.84161,,,AUDUSD
4051,2009.08.05 19:54,sell,2033,0.01,1.71525,,,EURAUD
4052,2009.08.05 19:59,buy,2034,0.01,0.89937,,,AUDCAD
4053,2009.08.05 19:59,buy,2035,0.01,0.89145,,,AUDCHF
4054,2009.08.05 19:59,buy,2036,0.01,79.6970,,,AUDJPY
4055,2009.08.05 19:59,buy,2037,0.01,1.24780,,,AUDNZD
4056,2009.08.05 19:59,buy,2038,0.01,0.84088,,,AUDUSD
4057,2009.08.05 19:59,sell,2039,0.01,2.02446,,,GBPAUD
4058,2009.08.06 04:27,close,2033,0.01,1.70877,6.96,17287.45,EURAUD
4059,2009.08.06 04:27,close,2026,0.01,1.70877,6.22,17293.67,EURAUD
4060,2009.08.06 04:27,close,2019,0.01,1.70877,3.92,17297.59,EURAUD
4061,2009.08.06 04:28,close,2036,0.01,80.1390,4.68,17302.27,AUDJPY
4062,2009.08.06 04:28,close,2028,0.01,80.1390,3.52,17305.79,AUDJPY
4063,2009.08.06 04:28,close,2022,0.01,80.1390,5.86,17311.65,AUDJPY
4064,2009.08.06 04:30,close,2035,0.01,0.89422,3.15,17314.80,AUDCHF
4065,2009.08.06 04:30,close,2027,0.01,0.89422,2.12,17316.92,AUDCHF
4066,2009.08.06 04:30,close,2020,0.01,0.89422,0.58,17317.50,AUDCHF
4067,2009.08.06 04:30,close,2037,0.01,1.25379,5.10,17322.60,AUDNZD
4068,2009.08.06 04:30,close,2031,0.01,1.25379,5.32,17327.92,AUDNZD
4069,2009.08.06 04:30,close,2023,0.01,1.25379,-5.56,17322.36,AUDNZD
4070,2009.08.06 04:31,close,2034,0.01,0.90180,2.54,17324.90,AUDCAD
4071,2009.08.06 04:31,close,2030,0.01,0.90180,2.22,17327.12,AUDCAD
4072,2009.08.06 04:31,close,2021,0.01,0.90180,5.22,17332.34,AUDCAD
4073,2009.08.06 04:31,close,2039,0.01,2.01563,9.39,17341.73,GBPAUD
4074,2009.08.06 04:31,close,2029,0.01,2.01563,8.04,17349.77,GBPAUD
4075,2009.08.06 04:31,close,2025,0.01,2.01563,-0.38,17349.39,GBPAUD
4076,2009.08.06 04:32,close,2038,0.01,0.84273,2.04,17351.43,AUDUSD
4077,2009.08.06 04:32,close,2032,0.01,0.84273,1.32,17352.75,AUDUSD
4078,2009.08.06 04:32,close,2024,0.01,0.84273,2.49,17355.24,AUDUSD
4079,2009.08.07 04:55,sell,2040,0.01,1.71195,,,EURAUD
4080,2009.08.07 04:59,buy,2041,0.01,0.89267,,,AUDCHF
4081,2009.08.07 04:59,buy,2042,0.01,79.9020,,,AUDJPY
4082,2009.08.07 05:00,buy,2043,0.01,0.90299,,,AUDCAD
4083,2009.08.07 05:00,buy,2044,0.01,1.24790,,,AUDNZD
4084,2009.08.07 05:00,buy,2045,0.01,0.83862,,,AUDUSD
4085,2009.08.07 05:00,sell,2046,0.01,1.99864,,,GBPAUD
4086,2009.08.07 05:11,sell,2047,0.01,1.71276,,,EURAUD
4087,2009.08.07 05:12,buy,2048,0.01,0.89198,,,AUDCHF
4088,2009.08.07 05:14,buy,2049,0.01,1.24696,,,AUDNZD
4089,2009.08.07 05:15,buy,2050,0.01,0.90221,,,AUDCAD
4090,2009.08.07 05:15,buy,2051,0.01,79.7790,,,AUDJPY
4091,2009.08.07 05:15,sell,2052,0.01,2.00134,,,GBPAUD
4092,2009.08.07 05:16,buy,2053,0.01,0.83787,,,AUDUSD
4093,2009.08.07 11:36,sell,2054,0.01,1.71635,,,EURAUD
4094,2009.08.07 11:38,buy,2055,0.01,0.90423,,,AUDCAD
4095,2009.08.07 11:38,sell,2056,0.01,2.00121,,,GBPAUD
4096,2009.08.07 11:39,buy,2057,0.01,0.89053,,,AUDCHF
4097,2009.08.07 11:39,buy,2058,0.01,79.5280,,,AUDJPY
4098,2009.08.07 11:39,buy,2059,0.01,1.24516,,,AUDNZD
4099,2009.08.07 11:41,buy,2060,0.01,0.83590,,,AUDUSD
4100,2009.08.07 20:55,close,2054,0.01,1.69321,23.85,17379.09,EURAUD
4101,2009.08.07 20:55,close,2047,0.01,1.69321,20.15,17399.24,EURAUD
4102,2009.08.07 20:55,close,2040,0.01,1.69321,19.31,17418.55,EURAUD
4103,2009.08.07 20:58,close,2058,0.01,81.5960,20.86,17439.41,AUDJPY
4104,2009.08.07 20:58,close,2051,0.01,81.5960,18.33,17457.74,AUDJPY
4105,2009.08.07 20:58,close,2042,0.01,81.5960,17.09,17474.83,AUDJPY
4106,2009.08.07 20:59,close,2055,0.01,0.90557,1.33,17476.16,AUDCAD
4107,2009.08.07 20:59,close,2050,0.01,0.90557,3.33,17479.49,AUDCAD
4108,2009.08.07 20:59,close,2043,0.01,0.90557,2.56,17482.05,AUDCAD
4109,2009.08.07 20:59,close,2057,0.01,0.90569,16.21,17498.26,AUDCHF
4110,2009.08.07 20:59,close,2048,0.01,0.90569,14.66,17512.92,AUDCHF
4111,2009.08.07 20:59,close,2041,0.01,0.90569,13.92,17526.84,AUDCHF
4112,2009.08.07 21:00,close,2059,0.01,1.24389,-1.09,17525.75,AUDNZD
4113,2009.08.07 21:00,close,2049,0.01,1.24389,-2.63,17523.12,AUDNZD
4114,2009.08.07 21:00,close,2044,0.01,1.24389,-3.43,17519.69,AUDNZD
4115,2009.08.07 21:00,close,2060,0.01,0.83653,0.63,17520.32,AUDUSD
4116,2009.08.07 21:00,close,2053,0.01,0.83653,-1.34,17518.98,AUDUSD
4117,2009.08.07 21:00,close,2045,0.01,0.83653,-2.09,17516.89,AUDUSD
4118,2009.08.07 21:00,close,2056,0.01,1.99122,10.30,17527.19,GBPAUD
4119,2009.08.07 21:00,close,2052,0.01,1.99122,10.43,17537.62,GBPAUD
4120,2009.08.07 21:00,close,2046,0.01,1.99122,7.65,17545.27,GBPAUD
4121,2009.08.11 07:25,sell,2061,0.01,1.69465,,,EURAUD
4122,2009.08.11 07:26,buy,2062,0.01,0.90576,,,AUDCHF
4123,2009.08.11 07:26,sell,2063,0.01,1.97469,,,GBPAUD
4124,2009.08.11 07:27,buy,2064,0.01,80.6640,,,AUDJPY
4125,2009.08.11 07:28,buy,2065,0.01,1.23648,,,AUDNZD
4126,2009.08.11 07:29,buy,2066,0.01,0.91012,,,AUDCAD
4127,2009.08.11 07:30,buy,2067,0.01,0.83453,,,AUDUSD
4128,2009.08.11 09:55,close,2061,0.01,1.69164,3.10,17548.37,EURAUD
4129,2009.08.11 09:59,close,2066,0.01,0.91257,2.43,17550.80,AUDCAD
4130,2009.08.11 09:59,close,2062,0.01,0.90678,1.09,17551.89,AUDCHF
4131,2009.08.11 09:59,close,2064,0.01,81.1140,4.54,17556.43,AUDJPY
4132,2009.08.11 09:59,close,2065,0.01,1.23920,2.32,17558.75,AUDNZD
4133,2009.08.11 09:59,close,2063,0.01,1.96557,9.40,17568.15,GBPAUD
4134,2009.08.11 10:00,close,2067,0.01,0.83761,3.08,17571.23,AUDUSD
4135,2009.08.11 19:55,buy,2068,0.01,0.89800,,,AUDCHF
4136,2009.08.11 19:58,buy,2069,0.01,1.24007,,,AUDNZD
4137,2009.08.11 19:58,sell,2070,0.01,1.70466,,,EURAUD
4138,2009.08.11 19:59,sell,2071,0.01,1.98444,,,GBPAUD
4139,2009.08.11 20:00,buy,2072,0.01,0.91333,,,AUDCAD
4140,2009.08.11 20:00,buy,2073,0.01,79.6330,,,AUDJPY
4141,2009.08.11 20:00,buy,2074,0.01,0.83001,,,AUDUSD
4142,2009.08.12 11:00,sell,2075,0.01,1.71633,,,EURAUD
4143,2009.08.12 11:00,sell,2076,0.01,1.71635,,,EURAUD
4144,2009.08.12 11:00,sell,2077,0.01,1.71637,,,EURAUD
4145,2009.08.12 11:05,buy,2078,0.01,0.90815,,,AUDCAD
4146,2009.08.12 11:05,buy,2079,0.01,0.90817,,,AUDCAD
4147,2009.08.12 11:05,buy,2080,0.01,0.90820,,,AUDCAD
4148,2009.08.12 11:05,buy,2081,0.01,0.88979,,,AUDCHF
4149,2009.08.12 11:05,buy,2082,0.01,0.88980,,,AUDCHF
4150,2009.08.12 11:05,buy,2083,0.01,0.88982,,,AUDCHF
4151,2009.08.12 11:05,buy,2084,0.01,78.6370,,,AUDJPY
4152,2009.08.12 11:05,buy,2085,0.01,78.6410,,,AUDJPY
4153,2009.08.12 11:05,buy,2086,0.01,78.6450,,,AUDJPY
4154,2009.08.12 11:05,buy,2087,0.01,1.23889,,,AUDNZD
4155,2009.08.12 11:05,buy,2088,0.01,1.23890,,,AUDNZD
4156,2009.08.12 11:05,buy,2089,0.01,1.23892,,,AUDNZD
4157,2009.08.12 11:05,buy,2090,0.02,0.82307,,,AUDUSD
4158,2009.08.12 11:05,buy,2091,0.01,0.82311,,,AUDUSD
4159,2009.08.12 11:05,sell,2092,0.01,1.99958,,,GBPAUD
4160,2009.08.12 11:05,sell,2093,0.01,1.99954,,,GBPAUD
4161,2009.08.12 11:05,sell,2094,0.01,1.99951,,,GBPAUD
4162,2009.08.12 20:14,close,2077,0.01,1.70712,9.53,17580.76,EURAUD
4163,2009.08.12 20:14,close,2076,0.01,1.70712,9.51,17590.27,EURAUD
4164,2009.08.12 20:14,close,2075,0.01,1.70712,9.49,17599.76,EURAUD
4165,2009.08.12 20:14,close,2070,0.01,1.70712,-2.44,17597.32,EURAUD
4166,2009.08.12 20:16,close,2083,0.01,0.89677,7.43,17604.75,AUDCHF
4167,2009.08.12 20:16,close,2082,0.01,0.89677,7.45,17612.20,AUDCHF
4168,2009.08.12 20:16,close,2081,0.01,0.89677,7.46,17619.66,AUDCHF
4169,2009.08.12 20:16,close,2068,0.01,0.89677,-1.26,17618.40,AUDCHF
4170,2009.08.12 20:17,close,2080,0.01,0.90604,-2.14,17616.26,AUDCAD
4171,2009.08.12 20:17,close,2079,0.01,0.90604,-2.11,17614.15,AUDCAD
4172,2009.08.12 20:17,close,2078,0.01,0.90604,-2.09,17612.06,AUDCAD
4173,2009.08.12 20:17,close,2072,0.01,0.90604,-7.19,17604.87,AUDCAD
4174,2009.08.12 20:17,close,2086,0.01,80.3370,17.07,17621.94,AUDJPY
4175,2009.08.12 20:17,close,2085,0.01,80.3370,17.11,17639.05,AUDJPY
4176,2009.08.12 20:17,close,2084,0.01,80.3370,17.15,17656.20,AUDJPY
4177,2009.08.12 20:17,close,2073,0.01,80.3370,7.17,17663.37,AUDJPY
4178,2009.08.12 20:17,close,2089,0.01,1.23797,-0.81,17662.56,AUDNZD
4179,2009.08.12 20:17,close,2088,0.01,1.23797,-0.80,17661.76,AUDNZD
4180,2009.08.12 20:17,close,2087,0.01,1.23797,-0.79,17660.97,AUDNZD
4181,2009.08.12 20:17,close,2069,0.01,1.23797,-1.79,17659.18,AUDNZD
4182,2009.08.12 20:17,close,2094,0.01,1.98419,15.79,17674.97,GBPAUD
4183,2009.08.12 20:17,close,2093,0.01,1.98419,15.82,17690.79,GBPAUD
4184,2009.08.12 20:17,close,2092,0.01,1.98419,15.86,17706.65,GBPAUD
4185,2009.08.12 20:17,close,2071,0.01,1.98419,0.36,17707.01,GBPAUD
4186,2009.08.12 20:19,close,2091,0.01,0.83095,7.84,17714.85,AUDUSD
4187,2009.08.12 20:19,close,2090,0.02,0.83095,15.76,17730.61,AUDUSD
4188,2009.08.12 20:19,close,2074,0.01,0.83095,1.00,17731.61,AUDUSD
4189,2009.08.17 00:55,buy,2095,0.01,0.89123,,,AUDCHF
4190,2009.08.17 00:56,sell,2096,0.01,1.70843,,,EURAUD
4191,2009.08.17 00:57,sell,2097,0.01,1.98816,,,GBPAUD
4192,2009.08.17 00:58,buy,2098,0.01,78.6420,,,AUDJPY
4193,2009.08.17 00:58,buy,2099,0.01,1.22838,,,AUDNZD
4194,2009.08.17 00:59,buy,2100,0.01,0.91307,,,AUDCAD
4195,2009.08.17 01:00,buy,2101,0.01,0.83066,,,AUDUSD
4196,2009.08.17 13:25,sell,2102,0.01,1.72088,,,EURAUD
4197,2009.08.17 13:25,sell,2103,0.01,1.72084,,,EURAUD
4198,2009.08.17 13:25,sell,2104,0.01,1.72080,,,EURAUD
4199,2009.08.17 13:29,buy,2105,0.01,0.90788,,,AUDCAD
4200,2009.08.17 13:29,buy,2106,0.01,77.2860,,,AUDJPY
4201,2009.08.17 13:29,buy,2107,0.01,1.22583,,,AUDNZD
4202,2009.08.17 13:29,sell,2108,0.01,1.99379,,,GBPAUD
4203,2009.08.17 13:30,buy,2109,0.01,0.90789,,,AUDCAD
4204,2009.08.17 13:30,buy,2110,0.01,0.90787,,,AUDCAD
4205,2009.08.17 13:30,buy,2111,0.01,0.88407,,,AUDCHF
4206,2009.08.17 13:30,buy,2112,0.01,0.88408,,,AUDCHF
4207,2009.08.17 13:30,buy,2113,0.01,0.88409,,,AUDCHF
4208,2009.08.17 13:30,buy,2114,0.01,77.2850,,,AUDJPY
4209,2009.08.17 13:30,buy,2115,0.01,77.2840,,,AUDJPY
4210,2009.08.17 13:30,buy,2116,0.01,1.22585,,,AUDNZD
4211,2009.08.17 13:30,buy,2117,0.01,1.22583,,,AUDNZD
4212,2009.08.17 13:30,buy,2118,0.02,0.81754,,,AUDUSD
4213,2009.08.17 13:30,buy,2119,0.01,0.81755,,,AUDUSD
4214,2009.08.17 13:30,sell,2120,0.01,1.99382,,,GBPAUD
4215,2009.08.17 13:30,sell,2121,0.01,1.99383,,,GBPAUD
4216,2009.08.18 09:43,close,2104,0.01,1.71062,10.59,17742.20,EURAUD
4217,2009.08.18 09:43,close,2103,0.01,1.71062,10.63,17752.83,EURAUD
4218,2009.08.18 09:43,close,2102,0.01,1.71062,10.67,17763.50,EURAUD
4219,2009.08.18 09:43,close,2096,0.01,1.71062,-2.15,17761.35,EURAUD
4220,2009.08.18 09:47,close,2113,0.01,0.88806,4.30,17765.65,AUDCHF
4221,2009.08.18 09:47,close,2112,0.01,0.88806,4.32,17769.97,AUDCHF
4222,2009.08.18 09:47,close,2111,0.01,0.88806,4.33,17774.30,AUDCHF
4223,2009.08.18 09:47,close,2095,0.01,0.88806,-3.33,17770.97,AUDCHF
4224,2009.08.18 09:48,close,2110,0.01,0.91097,3.12,17774.09,AUDCAD
4225,2009.08.18 09:48,close,2109,0.01,0.91097,3.10,17777.19,AUDCAD
4226,2009.08.18 09:48,close,2105,0.01,0.91097,3.11,17780.30,AUDCAD
4227,2009.08.18 09:48,close,2100,0.01,0.91097,-2.04,17778.26,AUDCAD
4228,2009.08.18 09:48,close,2115,0.01,78.4640,11.98,17790.24,AUDJPY
4229,2009.08.18 09:48,close,2114,0.01,78.4640,11.97,17802.21,AUDJPY
4230,2009.08.18 09:48,close,2106,0.01,78.4640,11.96,17814.17,AUDJPY
4231,2009.08.18 09:48,close,2098,0.01,78.4640,-1.72,17812.45,AUDJPY
4232,2009.08.18 09:48,close,2117,0.01,1.22795,1.81,17814.26,AUDNZD
4233,2009.08.18 09:48,close,2116,0.01,1.22795,1.79,17816.05,AUDNZD
4234,2009.08.18 09:48,close,2107,0.01,1.22795,1.81,17817.86,AUDNZD
4235,2009.08.18 09:48,close,2099,0.01,1.22795,-0.37,17817.49,AUDNZD
4236,2009.08.18 09:48,close,2119,0.01,0.82525,7.77,17825.26,AUDUSD
4237,2009.08.18 09:48,close,2118,0.02,0.82525,15.55,17840.81,AUDUSD
4238,2009.08.18 09:48,close,2101,0.01,0.82525,-5.34,17835.47,AUDUSD
4239,2009.08.18 09:48,close,2121,0.01,1.98574,8.43,17843.90,GBPAUD
4240,2009.08.18 09:48,close,2120,0.01,1.98574,8.42,17852.32,GBPAUD
4241,2009.08.18 09:48,close,2108,0.01,1.98574,8.39,17860.71,GBPAUD
4242,2009.08.18 09:48,close,2097,0.01,1.98574,2.59,17863.30,GBPAUD
4243,2009.08.18 16:29,sell,2122,0.01,1.71495,,,EURAUD
4244,2009.08.18 16:34,buy,2123,0.01,0.91086,,,AUDCAD
4245,2009.08.18 16:34,buy,2124,0.01,0.88738,,,AUDCHF
4246,2009.08.18 16:34,buy,2125,0.01,77.9350,,,AUDJPY
4247,2009.08.18 16:34,buy,2126,0.01,1.22245,,,AUDNZD
4248,2009.08.18 16:34,buy,2127,0.01,0.82275,,,AUDUSD
4249,2009.08.18 16:34,sell,2128,0.01,2.00852,,,GBPAUD
4250,2009.08.19 02:55,close,2122,0.01,1.70913,6.09,17869.39,EURAUD
4251,2009.08.19 02:57,close,2128,0.01,1.99670,12.28,17881.67,GBPAUD
4252,2009.08.19 02:59,close,2125,0.01,78.4370,5.13,17886.80,AUDJPY
4253,2009.08.19 03:00,close,2123,0.01,0.91201,1.18,17887.98,AUDCAD
4254,2009.08.19 03:00,close,2124,0.01,0.88933,2.15,17890.13,AUDCHF
4255,2009.08.19 03:00,close,2126,0.01,1.22505,2.22,17892.35,AUDNZD
4256,2009.08.19 03:00,close,2127,0.01,0.82817,5.49,17897.84,AUDUSD
4257,2009.08.19 10:57,sell,2129,0.01,1.71838,,,EURAUD
4258,2009.08.19 11:01,buy,2130,0.01,0.88475,,,AUDCHF
4259,2009.08.19 11:02,buy,2131,0.01,0.90946,,,AUDCAD
4260,2009.08.19 11:02,buy,2132,0.01,77.4570,,,AUDJPY
4261,2009.08.19 11:02,buy,2133,0.01,1.22531,,,AUDNZD
4262,2009.08.19 11:02,buy,2134,0.01,0.82122,,,AUDUSD
4263,2009.08.19 11:02,sell,2135,0.01,1.99664,,,GBPAUD
4264,2009.08.19 12:37,sell,2136,0.01,1.71920,,,EURAUD
4265,2009.08.19 12:40,buy,2137,0.01,0.88262,,,AUDCHF
4266,2009.08.19 12:41,sell,2138,0.01,1.99891,,,GBPAUD
4267,2009.08.19 12:42,buy,2139,0.01,0.90887,,,AUDCAD
4268,2009.08.19 12:42,buy,2140,0.01,77.1950,,,AUDJPY
4269,2009.08.19 12:42,buy,2141,0.01,1.22478,,,AUDNZD
4270,2009.08.19 12:42,buy,2142,0.01,0.81988,,,AUDUSD
4271,2009.08.20 04:25,close,2136,0.01,1.71287,6.81,17904.65,EURAUD
4272,2009.08.20 04:25,close,2129,0.01,1.71287,5.97,17910.62,EURAUD
4273,2009.08.20 04:26,close,2138,0.01,1.99076,8.70,17919.32,GBPAUD
4274,2009.08.20 04:26,close,2135,0.01,1.99076,6.36,17925.68,GBPAUD
4275,2009.08.20 04:28,close,2137,0.01,0.88519,2.94,17928.62,AUDCHF
4276,2009.08.20 04:28,close,2130,0.01,0.88519,0.66,17929.28,AUDCHF
4277,2009.08.20 04:29,close,2139,0.01,0.90961,0.87,17930.15,AUDCAD
4278,2009.08.20 04:29,close,2131,0.01,0.90961,0.28,17930.43,AUDCAD
4279,2009.08.20 04:29,close,2140,0.01,78.2420,10.78,17941.21,AUDJPY
4280,2009.08.20 04:29,close,2132,0.01,78.2420,8.14,17949.35,AUDJPY
4281,2009.08.20 04:29,close,2141,0.01,1.22754,2.35,17951.70,AUDNZD
4282,2009.08.20 04:29,close,2133,0.01,1.22754,1.89,17953.59,AUDNZD
4283,2009.08.20 04:30,close,2142,0.01,0.82965,9.96,17963.55,AUDUSD
4284,2009.08.20 04:30,close,2134,0.01,0.82965,8.63,17972.18,AUDUSD
4285,2009.08.21 07:55,sell,2143,0.01,1.72534,,,EURAUD
4286,2009.08.21 07:59,buy,2144,0.01,0.90103,,,AUDCAD
4287,2009.08.21 07:59,buy,2145,0.01,0.87875,,,AUDCHF
4288,2009.08.21 07:59,buy,2146,0.01,1.22418,,,AUDNZD
4289,2009.08.21 07:59,sell,2147,0.01,1.99239,,,GBPAUD
4290,2009.08.21 08:00,buy,2148,0.01,77.3940,,,AUDJPY
4291,2009.08.21 08:00,buy,2149,0.01,0.82543,,,AUDUSD
4292,2009.08.21 17:55,close,2143,0.01,1.71407,11.61,17983.79,EURAUD
4293,2009.08.21 17:59,close,2144,0.01,0.90097,-0.06,17983.73,AUDCAD
4294,2009.08.21 17:59,close,2145,0.01,0.88566,7.38,17991.11,AUDCHF
4295,2009.08.21 17:59,close,2148,0.01,78.9790,15.99,18007.10,AUDJPY
4296,2009.08.21 17:59,close,2146,0.01,1.22206,-1.81,18005.29,AUDNZD
4297,2009.08.21 17:59,close,2147,0.01,1.97640,16.48,18021.77,GBPAUD
4298,2009.08.21 18:00,close,2149,0.01,0.83469,9.26,18031.03,AUDUSD
4299,2009.08.25 04:58,sell,2150,0.01,1.70907,,,EURAUD
4300,2009.08.25 05:03,buy,2151,0.01,0.90102,,,AUDCAD
4301,2009.08.25 05:03,buy,2152,0.01,0.88745,,,AUDCHF
4302,2009.08.25 05:03,buy,2153,0.01,78.6340,,,AUDJPY
4303,2009.08.25 05:03,buy,2154,0.01,1.22047,,,AUDNZD
4304,2009.08.25 05:03,buy,2155,0.01,0.83632,,,AUDUSD
4305,2009.08.25 05:03,sell,2156,0.01,1.96085,,,GBPAUD
4306,2009.08.26 16:27,sell,2157,0.01,1.71924,,,EURAUD
4307,2009.08.26 16:31,sell,2158,0.01,1.95748,,,GBPAUD
4308,2009.08.26 16:32,buy,2159,0.01,0.90817,,,AUDCAD
4309,2009.08.26 16:32,buy,2160,0.01,0.88408,,,AUDCHF
4310,2009.08.26 16:32,buy,2161,0.01,78.1380,,,AUDJPY
4311,2009.08.26 16:32,buy,2162,0.01,1.21430,,,AUDNZD
4312,2009.08.26 16:32,buy,2163,0.01,0.82789,,,AUDUSD
4313,2009.08.26 23:55,sell,2164,0.01,1.96234,,,GBPAUD
4314,2009.08.26 23:57,buy,2165,0.01,0.88352,,,AUDCHF
4315,2009.08.27 00:00,buy,2166,0.01,0.90788,,,AUDCAD
4316,2009.08.27 00:00,buy,2167,0.01,77.9240,,,AUDJPY
4317,2009.08.27 00:00,buy,2168,0.01,1.21376,,,AUDNZD
4318,2009.08.27 00:00,buy,2169,0.01,0.82698,,,AUDUSD
4319,2009.08.27 00:00,sell,2170,0.01,1.72168,,,EURAUD
4320,2009.08.27 04:25,sell,2171,0.01,1.72312,,,EURAUD
4321,2009.08.27 04:26,sell,2172,0.01,1.96306,,,GBPAUD
4322,2009.08.27 04:29,buy,2173,0.01,77.6310,,,AUDJPY
4323,2009.08.27 04:29,buy,2174,0.01,1.21612,,,AUDNZD
4324,2009.08.27 04:30,buy,2175,0.01,0.90748,,,AUDCAD
4325,2009.08.27 04:30,buy,2176,0.01,0.88336,,,AUDCHF
4326,2009.08.27 04:30,buy,2177,0.01,0.82670,,,AUDUSD
4327,2009.08.27 15:55,close,2171,0.01,1.71383,9.57,18040.60,EURAUD
4328,2009.08.27 15:55,close,2170,0.01,1.71383,8.09,18048.69,EURAUD
4329,2009.08.27 15:55,close,2157,0.01,1.71383,5.86,18054.55,EURAUD
4330,2009.08.27 15:55,close,2150,0.01,1.71383,-4.51,18050.04,EURAUD
4331,2009.08.27 15:58,close,2172,0.01,1.94481,18.81,18068.85,GBPAUD
4332,2009.08.27 15:58,close,2164,0.01,1.94481,18.37,18087.22,GBPAUD
4333,2009.08.27 15:58,close,2158,0.01,1.94481,13.36,18100.58,GBPAUD
4334,2009.08.27 15:58,close,2156,0.01,1.94481,16.93,18117.51,GBPAUD
4335,2009.08.27 15:59,close,2175,0.01,0.91252,5.00,18122.51,AUDCAD
4336,2009.08.27 15:59,close,2166,0.01,0.91252,4.61,18127.12,AUDCAD
4337,2009.08.27 15:59,close,2159,0.01,0.91252,4.45,18131.57,AUDCAD
4338,2009.08.27 15:59,close,2151,0.01,0.91252,11.58,18143.15,AUDCAD
4339,2009.08.27 15:59,close,2176,0.01,0.88867,5.67,18148.82,AUDCHF
4340,2009.08.27 15:59,close,2165,0.01,0.88867,5.69,18154.51,AUDCHF
4341,2009.08.27 15:59,close,2160,0.01,0.88867,5.10,18159.61,AUDCHF
4342,2009.08.27 15:59,close,2152,0.01,0.88867,1.56,18161.17,AUDCHF
4343,2009.08.27 15:59,close,2173,0.01,77.7750,1.46,18162.63,AUDJPY
4344,2009.08.27 15:59,close,2167,0.01,77.7750,-1.50,18161.13,AUDJPY
4345,2009.08.27 15:59,close,2161,0.01,77.7750,-3.44,18157.69,AUDJPY
4346,2009.08.27 15:59,close,2153,0.01,77.7750,-8.37,18149.32,AUDJPY
4347,2009.08.27 15:59,close,2174,0.01,1.22170,4.76,18154.08,AUDNZD
4348,2009.08.27 15:59,close,2168,0.01,1.22170,6.77,18160.85,AUDNZD
4349,2009.08.27 15:59,close,2162,0.01,1.22170,6.30,18167.15,AUDNZD
4350,2009.08.27 15:59,close,2154,0.01,1.22170,1.04,18168.19,AUDNZD
4351,2009.08.27 16:00,close,2177,0.01,0.83061,3.91,18172.10,AUDUSD
4352,2009.08.27 16:00,close,2169,0.01,0.83061,3.63,18175.73,AUDUSD
4353,2009.08.27 16:00,close,2163,0.01,0.83061,2.92,18178.65,AUDUSD
4354,2009.08.27 16:00,close,2155,0.01,0.83061,-5.45,18173.20,AUDUSD
4355,2009.09.01 07:25,sell,2178,0.01,1.70504,,,EURAUD
4356,2009.09.01 07:27,buy,2179,0.01,1.22493,,,AUDNZD
4357,2009.09.01 07:29,buy,2180,0.01,0.92011,,,AUDCAD
4358,2009.09.01 07:29,buy,2181,0.01,0.89067,,,AUDCHF
4359,2009.09.01 07:29,buy,2182,0.01,78.3980,,,AUDJPY
4360,2009.09.01 07:29,sell,2183,0.01,1.93484,,,GBPAUD
4361,2009.09.01 07:30,buy,2184,0.01,0.84244,,,AUDUSD
4362,2009.09.01 13:25,sell,2185,0.01,1.71031,,,EURAUD
4363,2009.09.01 13:25,sell,2186,0.01,1.71029,,,EURAUD
4364,2009.09.01 13:28,sell,2187,0.01,1.94081,,,GBPAUD
4365,2009.09.01 13:28,sell,2188,0.01,1.94079,,,GBPAUD
4366,2009.09.01 13:29,buy,2189,0.01,0.91595,,,AUDCAD
4367,2009.09.01 13:29,buy,2190,0.01,0.91594,,,AUDCAD
4368,2009.09.01 13:29,buy,2191,0.01,1.22544,,,AUDNZD
4369,2009.09.01 13:29,buy,2192,0.01,1.22541,,,AUDNZD
4370,2009.09.01 13:30,buy,2193,0.01,0.88637,,,AUDCHF
4371,2009.09.01 13:30,buy,2194,0.01,0.88638,,,AUDCHF
4372,2009.09.01 13:30,buy,2195,0.01,77.8860,,,AUDJPY
4373,2009.09.01 13:30,buy,2196,0.01,77.8940,,,AUDJPY
4374,2009.09.01 13:30,buy,2197,0.01,0.83642,,,AUDUSD
4375,2009.09.01 13:30,buy,2198,0.01,0.83645,,,AUDUSD
4376,2009.09.02 00:25,buy,2199,0.01,1.22316,,,AUDNZD
4377,2009.09.02 00:25,buy,2200,0.01,1.22313,,,AUDNZD
4378,2009.09.02 00:25,buy,2201,0.01,1.22327,,,AUDNZD
4379,2009.09.02 00:25,sell,2202,0.01,1.71777,,,EURAUD
4380,2009.09.02 00:25,sell,2203,0.01,1.71773,,,EURAUD
4381,2009.09.02 00:25,sell,2204,0.01,1.71769,,,EURAUD
4382,2009.09.02 00:26,buy,2205,0.01,76.9100,,,AUDJPY
4383,2009.09.02 00:26,buy,2206,0.01,76.9180,,,AUDJPY
4384,2009.09.02 00:26,buy,2207,0.01,76.9260,,,AUDJPY
4385,2009.09.02 00:27,buy,2208,0.01,0.88218,,,AUDCHF
4386,2009.09.02 00:28,buy,2209,0.01,0.88219,,,AUDCHF
4387,2009.09.02 00:28,buy,2210,0.01,0.88212,,,AUDCHF
4388,2009.09.02 00:29,buy,2211,0.01,0.91323,,,AUDCAD
4389,2009.09.02 00:29,buy,2212,0.01,0.91322,,,AUDCAD
4390,2009.09.02 00:29,buy,2213,0.01,0.91325,,,AUDCAD
4391,2009.09.02 00:29,sell,2214,0.01,1.95205,,,GBPAUD
4392,2009.09.02 00:29,sell,2215,0.01,1.95201,,,GBPAUD
4393,2009.09.02 00:29,sell,2216,0.01,1.95208,,,GBPAUD
4394,2009.09.02 00:30,buy,2217,0.02,0.82776,,,AUDUSD
4395,2009.09.02 00:30,buy,2218,0.01,0.82775,,,AUDUSD
4396,2009.09.02 02:55,sell,2219,0.01,1.71926,,,EURAUD
4397,2009.09.02 02:57,sell,2220,0.01,1.95324,,,GBPAUD
4398,2009.09.02 02:58,buy,2221,0.01,0.88135,,,AUDCHF
4399,2009.09.02 02:59,buy,2222,0.01,76.6270,,,AUDJPY
4400,2009.09.02 02:59,buy,2223,0.01,1.22304,,,AUDNZD
4401,2009.09.02 03:00,buy,2224,0.01,0.91111,,,AUDCAD
4402,2009.09.02 03:00,buy,2225,0.01,0.82593,,,AUDUSD
4403,2009.09.02 09:02,close,2219,0.01,1.70917,10.40,18183.60,EURAUD
4404,2009.09.02 09:02,close,2204,0.01,1.70917,8.78,18192.38,EURAUD
4405,2009.09.02 09:02,close,2203,0.01,1.70917,8.82,18201.20,EURAUD
4406,2009.09.02 09:02,close,2202,0.01,1.70917,8.86,18210.06,EURAUD
4407,2009.09.02 09:02,close,2186,0.01,1.70917,1.25,18211.31,EURAUD
4408,2009.09.02 09:02,close,2185,0.01,1.70917,1.27,18212.58,EURAUD
4409,2009.09.02 09:02,close,2178,0.01,1.70917,-4.16,18208.42,EURAUD
4410,2009.09.02 09:07,close,2224,0.01,0.91777,6.60,18215.02,AUDCAD
4411,2009.09.02 09:07,close,2213,0.01,0.91777,4.48,18219.50,AUDCAD
4412,2009.09.02 09:07,close,2212,0.01,0.91777,4.51,18224.01,AUDCAD
4413,2009.09.02 09:07,close,2211,0.01,0.91777,4.50,18228.51,AUDCAD
4414,2009.09.02 09:07,close,2190,0.01,0.91777,1.85,18230.36,AUDCAD
4415,2009.09.02 09:07,close,2189,0.01,0.91777,1.84,18232.20,AUDCAD
4416,2009.09.02 09:07,close,2180,0.01,0.91777,-2.28,18229.92,AUDCAD
4417,2009.09.02 09:07,close,2221,0.01,0.88685,5.88,18235.80,AUDCHF
4418,2009.09.02 09:07,close,2210,0.01,0.88685,5.06,18240.86,AUDCHF
4419,2009.09.02 09:07,close,2209,0.01,0.88685,4.99,18245.85,AUDCHF
4420,2009.09.02 09:07,close,2208,0.01,0.88685,5.00,18250.85,AUDCHF
4421,2009.09.02 09:07,close,2194,0.01,0.88685,0.57,18251.42,AUDCHF
4422,2009.09.02 09:07,close,2193,0.01,0.88685,0.58,18252.00,AUDCHF
4423,2009.09.02 09:07,close,2181,0.01,0.88685,-4.02,18247.98,AUDCHF
4424,2009.09.02 09:07,close,2222,0.01,77.3110,6.90,18254.88,AUDJPY
4425,2009.09.02 09:07,close,2207,0.01,77.3110,3.89,18258.77,AUDJPY
4426,2009.09.02 09:07,close,2206,0.01,77.3110,3.97,18262.74,AUDJPY
4427,2009.09.02 09:07,close,2205,0.01,77.3110,4.05,18266.79,AUDJPY
4428,2009.09.02 09:07,close,2196,0.01,77.3110,-5.81,18260.98,AUDJPY
4429,2009.09.02 09:07,close,2195,0.01,77.3110,-5.73,18255.25,AUDJPY
4430,2009.09.02 09:07,close,2182,0.01,77.3110,-10.89,18244.36,AUDJPY
4431,2009.09.02 09:07,close,2223,0.01,1.22992,5.87,18250.23,AUDNZD
4432,2009.09.02 09:07,close,2201,0.01,1.22992,5.68,18255.91,AUDNZD
4433,2009.09.02 09:07,close,2200,0.01,1.22992,5.80,18261.71,AUDNZD
4434,2009.09.02 09:07,close,2199,0.01,1.22992,5.77,18267.48,AUDNZD
4435,2009.09.02 09:07,close,2192,0.01,1.22992,3.85,18271.33,AUDNZD
4436,2009.09.02 09:07,close,2191,0.01,1.22992,3.82,18275.15,AUDNZD
4437,2009.09.02 09:07,close,2179,0.01,1.22992,4.26,18279.41,AUDNZD
4438,2009.09.02 09:07,close,2225,0.01,0.83176,5.83,18285.24,AUDUSD
4439,2009.09.02 09:07,close,2218,0.01,0.83176,4.01,18289.25,AUDUSD
4440,2009.09.02 09:07,close,2217,0.02,0.83176,8.00,18297.25,AUDUSD
4441,2009.09.02 09:07,close,2198,0.01,0.83176,-4.63,18292.62,AUDUSD
4442,2009.09.02 09:07,close,2197,0.01,0.83176,-4.59,18288.03,AUDUSD
4443,2009.09.02 09:07,close,2184,0.01,0.83176,-10.62,18277.41,AUDUSD
4444,2009.09.02 09:07,close,2220,0.01,1.94232,11.25,18288.66,GBPAUD
4445,2009.09.02 09:07,close,2216,0.01,1.94232,10.05,18298.71,GBPAUD
4446,2009.09.02 09:07,close,2215,0.01,1.94232,9.98,18308.69,GBPAUD
4447,2009.09.02 09:07,close,2214,0.01,1.94232,10.02,18318.71,GBPAUD
4448,2009.09.02 09:07,close,2188,0.01,1.94232,-1.48,18317.23,GBPAUD
4449,2009.09.02 09:07,close,2187,0.01,1.94232,-1.46,18315.77,GBPAUD
4450,2009.09.02 09:07,close,2183,0.01,1.94232,-7.61,18308.16,GBPAUD
4451,2009.09.08 04:25,sell,2226,0.01,1.67780,,,EURAUD
4452,2009.09.08 04:26,buy,2227,0.01,79.2990,,,AUDJPY
4453,2009.09.08 04:28,buy,2228,0.01,0.92134,,,AUDCAD
4454,2009.09.08 04:28,buy,2229,0.01,0.90553,,,AUDCHF
4455,2009.09.08 04:28,sell,2230,0.01,1.91214,,,GBPAUD
4456,2009.09.08 04:29,buy,2231,0.01,1.23323,,,AUDNZD
4457,2009.09.08 04:30,buy,2232,0.01,0.85451,,,AUDUSD
4458,2009.09.08 08:25,close,2226,0.01,1.67636,1.49,18309.65,EURAUD
4459,2009.09.08 08:27,close,2230,0.01,1.90947,2.75,18312.40,GBPAUD
4460,2009.09.08 08:29,close,2228,0.01,0.92155,0.21,18312.61,AUDCAD
4461,2009.09.08 08:29,close,2229,0.01,0.90562,0.10,18312.71,AUDCHF
4462,2009.09.08 08:29,close,2227,0.01,79.3640,0.65,18313.36,AUDJPY
4463,2009.09.08 08:30,close,2231,0.01,1.23543,1.87,18315.23,AUDNZD
4464,2009.09.08 08:30,close,2232,0.01,0.85717,2.66,18317.89,AUDUSD
4465,2009.09.09 07:57,sell,2233,0.01,1.68637,,,EURAUD
4466,2009.09.09 08:02,buy,2234,0.01,0.92743,,,AUDCAD
4467,2009.09.09 08:02,buy,2235,0.01,0.89982,,,AUDCHF
4468,2009.09.09 08:02,buy,2236,0.01,79.4520,,,AUDJPY
4469,2009.09.09 08:02,buy,2237,0.01,1.23480,,,AUDNZD
4470,2009.09.09 08:02,buy,2238,0.01,0.86049,,,AUDUSD
4471,2009.09.09 08:02,sell,2239,0.01,1.92273,,,GBPAUD
4472,2009.09.09 14:25,close,2239,0.01,1.91271,10.32,18328.21,GBPAUD
4473,2009.09.09 14:28,close,2233,0.01,1.68335,3.12,18331.33,EURAUD
4474,2009.09.09 14:29,close,2234,0.01,0.93011,2.66,18333.99,AUDCAD
4475,2009.09.09 14:29,close,2235,0.01,0.90124,1.52,18335.51,AUDCHF
4476,2009.09.09 14:29,close,2236,0.01,79.7340,2.85,18338.36,AUDJPY
4477,2009.09.09 14:29,close,2237,0.01,1.23581,0.86,18339.22,AUDNZD
4478,2009.09.09 14:30,close,2238,0.01,0.86420,3.71,18342.93,AUDUSD
4479,2009.09.10 07:55,sell,2240,0.01,1.69448,,,EURAUD
4480,2009.09.10 07:59,buy,2241,0.01,0.89445,,,AUDCHF
4481,2009.09.10 07:59,sell,2242,0.01,1.92302,,,GBPAUD
4482,2009.09.10 08:00,buy,2243,0.01,0.92811,,,AUDCAD
4483,2009.09.10 08:00,buy,2244,0.01,79.2870,,,AUDJPY
4484,2009.09.10 08:00,buy,2245,0.01,1.23278,,,AUDNZD
4485,2009.09.10 08:00,buy,2246,0.01,0.86065,,,AUDUSD
4486,2009.09.10 10:20,sell,2247,0.01,1.69643,,,EURAUD
4487,2009.09.10 10:24,sell,2248,0.01,1.92426,,,GBPAUD
4488,2009.09.10 10:25,buy,2249,0.01,0.92827,,,AUDCAD
4489,2009.09.10 10:25,buy,2250,0.01,0.89269,,,AUDCHF
4490,2009.09.10 10:25,buy,2251,0.01,78.9980,,,AUDJPY
4491,2009.09.10 10:25,buy,2252,0.01,1.23608,,,AUDNZD
4492,2009.09.10 10:25,buy,2253,0.01,0.85783,,,AUDUSD
4493,2009.09.10 11:13,sell,2254,0.01,1.69775,,,EURAUD
4494,2009.09.10 11:17,sell,2255,0.01,1.92852,,,GBPAUD
4495,2009.09.10 11:18,buy,2256,0.01,0.92763,,,AUDCAD
4496,2009.09.10 11:18,buy,2257,0.01,0.89210,,,AUDCHF
4497,2009.09.10 11:18,buy,2258,0.01,78.9780,,,AUDJPY
4498,2009.09.10 11:18,buy,2259,0.01,1.23494,,,AUDNZD
4499,2009.09.10 11:18,buy,2260,0.01,0.85694,,,AUDUSD
4500,2009.09.10 12:46,sell,2261,0.01,1.69960,,,EURAUD
4501,2009.09.10 12:49,sell,2262,0.01,1.93095,,,GBPAUD
4502,2009.09.10 12:51,buy,2263,0.01,0.92867,,,AUDCAD
4503,2009.09.10 12:51,buy,2264,0.01,0.89155,,,AUDCHF
4504,2009.09.10 12:51,buy,2265,0.01,78.8000,,,AUDJPY
4505,2009.09.10 12:51,buy,2266,0.01,1.23276,,,AUDNZD
4506,2009.09.10 12:51,buy,2267,0.01,0.85513,,,AUDUSD
4507,2009.09.14 04:25,sell,2268,0.01,1.69547,,,EURAUD
4508,2009.09.14 04:28,buy,2269,0.01,0.89129,,,AUDCHF
4509,2009.09.14 04:30,buy,2270,0.01,0.93019,,,AUDCAD
4510,2009.09.14 04:30,buy,2271,0.01,77.5150,,,AUDJPY
4511,2009.09.14 04:30,buy,2272,0.01,1.22729,,,AUDNZD
4512,2009.09.14 04:30,buy,2273,0.01,0.85787,,,AUDUSD
4513,2009.09.14 04:30,sell,2274,0.01,1.93596,,,GBPAUD
4514,2009.09.14 04:40,sell,2275,0.01,1.69592,,,EURAUD
4515,2009.09.14 04:45,buy,2276,0.01,0.92952,,,AUDCAD
4516,2009.09.14 04:45,buy,2277,0.01,0.89053,,,AUDCHF
4517,2009.09.14 04:45,buy,2278,0.01,77.4300,,,AUDJPY
4518,2009.09.14 04:45,buy,2279,0.01,1.22701,,,AUDNZD
4519,2009.09.14 04:45,buy,2280,0.01,0.85700,,,AUDUSD
4520,2009.09.14 04:45,sell,2281,0.01,1.93806,,,GBPAUD
4521,2009.09.16 03:25,close,2275,0.01,1.69563,0.50,18343.43,EURAUD
4522,2009.09.16 03:25,close,2268,0.01,1.69563,0.03,18343.46,EURAUD
4523,2009.09.16 03:25,close,2261,0.01,1.69563,4.48,18347.94,EURAUD
4524,2009.09.16 03:25,close,2254,0.01,1.69563,2.57,18350.51,EURAUD
4525,2009.09.16 03:25,close,2247,0.01,1.69563,1.21,18351.72,EURAUD
4526,2009.09.16 03:25,close,2240,0.01,1.69563,-0.80,18350.92,EURAUD
4527,2009.09.16 03:26,close,2278,0.01,78.6380,12.33,18363.25,AUDJPY
4528,2009.09.16 03:26,close,2271,0.01,78.6380,11.48,18374.73,AUDJPY
4529,2009.09.16 03:26,close,2265,0.01,78.6380,-1.35,18373.38,AUDJPY
4530,2009.09.16 03:26,close,2258,0.01,78.6380,-3.14,18370.24,AUDJPY
4531,2009.09.16 03:26,close,2251,0.01,78.6380,-3.34,18366.90,AUDJPY
4532,2009.09.16 03:26,close,2244,0.01,78.6380,-6.26,18360.64,AUDJPY
4533,2009.09.16 03:27,close,2277,0.01,0.89379,3.61,18364.25,AUDCHF
4534,2009.09.16 03:27,close,2269,0.01,0.89379,2.80,18367.05,AUDCHF
4535,2009.09.16 03:27,close,2264,0.01,0.89379,2.65,18369.70,AUDCHF
4536,2009.09.16 03:27,close,2257,0.01,0.89379,2.06,18371.76,AUDCHF
4537,2009.09.16 03:27,close,2250,0.01,0.89379,1.43,18373.19,AUDCHF
4538,2009.09.16 03:27,close,2241,0.01,0.89379,-0.45,18372.74,AUDCHF
4539,2009.09.16 03:27,close,2279,0.01,1.22482,-1.88,18370.86,AUDNZD
4540,2009.09.16 03:27,close,2272,0.01,1.22482,-2.12,18368.74,AUDNZD
4541,2009.09.16 03:27,close,2266,0.01,1.22482,-6.78,18361.96,AUDNZD
4542,2009.09.16 03:27,close,2259,0.01,1.22482,-8.65,18353.31,AUDNZD
4543,2009.09.16 03:27,close,2252,0.01,1.22482,-9.62,18343.69,AUDNZD
4544,2009.09.16 03:27,close,2245,0.01,1.22482,-6.80,18336.89,AUDNZD
4545,2009.09.16 03:27,close,2281,0.01,1.90676,32.45,18369.34,GBPAUD
4546,2009.09.16 03:27,close,2274,0.01,1.90676,30.28,18399.62,GBPAUD
4547,2009.09.16 03:27,close,2262,0.01,1.90676,25.32,18424.94,GBPAUD
4548,2009.09.16 03:27,close,2255,0.01,1.90676,22.82,18447.76,GBPAUD
4549,2009.09.16 03:27,close,2248,0.01,1.90676,18.43,18466.19,GBPAUD
4550,2009.09.16 03:27,close,2242,0.01,1.90676,17.15,18483.34,GBPAUD
4551,2009.09.16 03:28,close,2276,0.01,0.92735,-2.07,18481.27,AUDCAD
4552,2009.09.16 03:28,close,2270,0.01,0.92735,-2.73,18478.54,AUDCAD
4553,2009.09.16 03:28,close,2263,0.01,0.92735,-1.14,18477.40,AUDCAD
4554,2009.09.16 03:28,close,2256,0.01,0.92735,-0.11,18477.29,AUDCAD
4555,2009.09.16 03:28,close,2249,0.01,0.92735,-0.75,18476.54,AUDCAD
4556,2009.09.16 03:28,close,2243,0.01,0.92735,-0.59,18475.95,AUDCAD
4557,2009.09.16 03:30,close,2280,0.01,0.86469,7.82,18483.77,AUDUSD
4558,2009.09.16 03:30,close,2273,0.01,0.86469,6.95,18490.72,AUDUSD
4559,2009.09.16 03:30,close,2267,0.01,0.86469,9.82,18500.54,AUDUSD
4560,2009.09.16 03:30,close,2260,0.01,0.86469,8.01,18508.55,AUDUSD
4561,2009.09.16 03:30,close,2253,0.01,0.86469,7.12,18515.67,AUDUSD
4562,2009.09.16 03:30,close,2246,0.01,0.86469,4.30,18519.97,AUDUSD
4563,2009.09.24 00:55,sell,2282,0.01,1.69479,,,EURAUD
4564,2009.09.24 00:57,buy,2283,0.01,0.89192,,,AUDCHF
4565,2009.09.24 00:57,sell,2284,0.01,1.88139,,,GBPAUD
4566,2009.09.24 00:58,buy,2285,0.01,79.3750,,,AUDJPY
4567,2009.09.24 00:59,buy,2286,0.01,1.20750,,,AUDNZD
4568,2009.09.24 01:00,buy,2287,0.01,0.93330,,,AUDCAD
4569,2009.09.24 01:00,buy,2288,0.01,0.86784,,,AUDUSD
4570,2009.09.24 01:12,sell,2289,0.01,1.69595,,,EURAUD
4571,2009.09.24 01:13,buy,2290,0.01,0.89145,,,AUDCHF
4572,2009.09.24 01:13,sell,2291,0.01,1.88347,,,GBPAUD
4573,2009.09.24 01:14,buy,2292,0.01,79.3460,,,AUDJPY
4574,2009.09.24 01:14,buy,2293,0.01,1.20627,,,AUDNZD
4575,2009.09.24 01:16,buy,2294,0.01,0.93184,,,AUDCAD
4576,2009.09.24 01:17,buy,2295,0.01,0.86643,,,AUDUSD
4577,2009.09.25 08:55,close,2289,0.01,1.69070,5.51,18525.48,EURAUD
4578,2009.09.25 08:55,close,2282,0.01,1.69070,4.31,18529.79,EURAUD
4579,2009.09.25 08:59,close,2290,0.01,0.89378,2.55,18532.34,AUDCHF
4580,2009.09.25 08:59,close,2283,0.01,0.89378,2.04,18534.38,AUDCHF
4581,2009.09.25 08:59,close,2293,0.01,1.20733,0.91,18535.29,AUDNZD
4582,2009.09.25 08:59,close,2286,0.01,1.20733,-0.14,18535.15,AUDNZD
4583,2009.09.25 08:59,close,2291,0.01,1.83918,45.74,18580.89,GBPAUD
4584,2009.09.25 08:59,close,2284,0.01,1.83918,43.59,18624.48,GBPAUD
4585,2009.09.25 09:00,close,2294,0.01,0.94541,13.50,18637.98,AUDCAD
4586,2009.09.25 09:00,close,2287,0.01,0.94541,12.05,18650.03,AUDCAD
4587,2009.09.25 09:00,close,2292,0.01,78.7820,-5.62,18644.41,AUDJPY
4588,2009.09.25 09:00,close,2285,0.01,78.7820,-5.92,18638.49,AUDJPY
4589,2009.09.25 09:00,close,2295,0.01,0.86915,2.79,18641.28,AUDUSD
4590,2009.09.25 09:00,close,2288,0.01,0.86915,1.38,18642.66,AUDUSD
4591,2009.10.02 03:25,sell,2296,0.01,1.67274,,,EURAUD
4592,2009.10.02 03:26,sell,2297,0.01,1.83155,,,GBPAUD
4593,2009.10.02 03:27,buy,2298,0.01,1.22095,,,AUDNZD
4594,2009.10.02 03:29,buy,2299,0.01,0.94175,,,AUDCAD
4595,2009.10.02 03:29,buy,2300,0.01,0.90523,,,AUDCHF
4596,2009.10.02 03:30,buy,2301,0.01,77.7460,,,AUDJPY
4597,2009.10.02 03:30,buy,2302,0.01,0.86844,,,AUDUSD
4598,2009.10.02 16:25,sell,2303,0.01,1.68573,,,EURAUD
4599,2009.10.02 16:25,sell,2304,0.01,1.68571,,,EURAUD
4600,2009.10.02 16:29,buy,2305,0.01,0.94001,,,AUDCAD
4601,2009.10.02 16:29,buy,2306,0.01,0.89702,,,AUDCHF
4602,2009.10.02 16:29,buy,2307,0.01,1.20907,,,AUDNZD
4603,2009.10.02 16:30,buy,2308,0.01,0.94000,,,AUDCAD
4604,2009.10.02 16:30,buy,2309,0.01,0.89703,,,AUDCHF
4605,2009.10.02 16:30,buy,2310,0.01,77.3930,,,AUDJPY
4606,2009.10.02 16:30,buy,2311,0.01,77.3960,,,AUDJPY
4607,2009.10.02 16:30,buy,2312,0.01,1.20905,,,AUDNZD
4608,2009.10.02 16:30,buy,2313,0.01,0.86893,,,AUDUSD
4609,2009.10.02 16:30,buy,2314,0.01,0.86896,,,AUDUSD
4610,2009.10.02 16:30,sell,2315,0.01,1.83107,,,GBPAUD
4611,2009.10.02 16:30,sell,2316,0.01,1.83108,,,GBPAUD
4612,2009.10.02 16:47,sell,2317,0.01,1.68397,,,EURAUD
4613,2009.10.02 16:51,buy,2318,0.01,0.93878,,,AUDCAD
4614,2009.10.02 16:51,buy,2319,0.01,0.89632,,,AUDCHF
4615,2009.10.02 16:51,sell,2320,0.01,1.83218,,,GBPAUD
4616,2009.10.02 16:52,buy,2321,0.01,77.2800,,,AUDJPY
4617,2009.10.02 16:52,buy,2322,0.01,1.20698,,,AUDNZD
4618,2009.10.02 16:52,buy,2323,0.01,0.86737,,,AUDUSD
4619,2009.10.02 22:25,sell,2324,0.01,1.68346,,,EURAUD
4620,2009.10.02 22:28,buy,2325,0.01,0.89602,,,AUDCHF
4621,2009.10.02 22:28,sell,2326,0.01,1.84001,,,GBPAUD
4622,2009.10.02 22:29,buy,2327,0.01,0.93645,,,AUDCAD
4623,2009.10.02 22:29,buy,2328,0.01,77.6410,,,AUDJPY
4624,2009.10.02 22:29,buy,2329,0.01,1.20539,,,AUDNZD
4625,2009.10.02 22:30,buy,2330,0.01,0.86537,,,AUDUSD
4626,2009.10.05 05:55,close,2324,0.01,1.67644,7.34,18650.00,EURAUD
4627,2009.10.05 05:55,close,2317,0.01,1.67644,7.86,18657.86,EURAUD
4628,2009.10.05 05:55,close,2304,0.01,1.67644,9.66,18667.52,EURAUD
4629,2009.10.05 05:55,close,2303,0.01,1.67644,9.68,18677.20,EURAUD
4630,2009.10.05 05:55,close,2296,0.01,1.67644,-3.71,18673.49,EURAUD
4631,2009.10.05 05:58,close,2325,0.01,0.90037,4.71,18678.20,AUDCHF
4632,2009.10.05 05:58,close,2319,0.01,0.90037,4.39,18682.59,AUDCHF
4633,2009.10.05 05:58,close,2309,0.01,0.90037,3.63,18686.22,AUDCHF
4634,2009.10.05 05:58,close,2306,0.01,0.90037,3.64,18689.86,AUDCHF
4635,2009.10.05 05:58,close,2300,0.01,0.90037,-5.13,18684.73,AUDCHF
4636,2009.10.05 05:58,close,2329,0.01,1.21122,4.98,18689.71,AUDNZD
4637,2009.10.05 05:58,close,2322,0.01,1.21122,3.62,18693.33,AUDNZD
4638,2009.10.05 05:58,close,2312,0.01,1.21122,1.85,18695.18,AUDNZD
4639,2009.10.05 05:58,close,2307,0.01,1.21122,1.84,18697.02,AUDNZD
4640,2009.10.05 05:58,close,2298,0.01,1.21122,-8.30,18688.72,AUDNZD
4641,2009.10.05 05:58,close,2326,0.01,1.83013,10.28,18699.00,GBPAUD
4642,2009.10.05 05:58,close,2320,0.01,1.83013,2.21,18701.21,GBPAUD
4643,2009.10.05 05:58,close,2316,0.01,1.83013,1.07,18702.28,GBPAUD
4644,2009.10.05 05:58,close,2315,0.01,1.83013,1.06,18703.34,GBPAUD
4645,2009.10.05 05:58,close,2297,0.01,1.83013,1.56,18704.90,GBPAUD
4646,2009.10.05 05:59,close,2327,0.01,0.93746,1.04,18705.94,AUDCAD
4647,2009.10.05 05:59,close,2318,0.01,0.93746,-1.27,18704.67,AUDCAD
4648,2009.10.05 05:59,close,2308,0.01,0.93746,-2.48,18702.19,AUDCAD
4649,2009.10.05 05:59,close,2305,0.01,0.93746,-2.49,18699.70,AUDCAD
4650,2009.10.05 05:59,close,2299,0.01,0.93746,-4.22,18695.48,AUDCAD
4651,2009.10.05 05:59,close,2328,0.01,78.3890,7.61,18703.09,AUDJPY
4652,2009.10.05 05:59,close,2321,0.01,78.3890,11.26,18714.35,AUDJPY
4653,2009.10.05 05:59,close,2311,0.01,78.3890,10.09,18724.44,AUDJPY
4654,2009.10.05 05:59,close,2310,0.01,78.3890,10.12,18734.56,AUDJPY
4655,2009.10.05 05:59,close,2301,0.01,78.3890,6.56,18741.12,AUDJPY
4656,2009.10.05 06:00,close,2330,0.01,0.87296,7.66,18748.78,AUDUSD
4657,2009.10.05 06:00,close,2323,0.01,0.87296,5.66,18754.44,AUDUSD
4658,2009.10.05 06:00,close,2314,0.01,0.87296,4.07,18758.51,AUDUSD
4659,2009.10.05 06:00,close,2313,0.01,0.87296,4.10,18762.61,AUDUSD
4660,2009.10.05 06:00,close,2302,0.01,0.87296,4.59,18767.20,AUDUSD
4661,2009.10.06 05:55,sell,2331,0.01,1.81025,,,GBPAUD
4662,2009.10.06 05:56,buy,2332,0.01,1.20358,,,AUDNZD
4663,2009.10.06 05:57,sell,2333,0.01,1.66720,,,EURAUD
4664,2009.10.06 05:58,buy,2334,0.01,0.90719,,,AUDCHF
4665,2009.10.06 05:59,buy,2335,0.01,0.94356,,,AUDCAD
4666,2009.10.06 05:59,buy,2336,0.01,78.6180,,,AUDJPY
4667,2009.10.06 06:00,buy,2337,0.01,0.88266,,,AUDUSD
4668,2009.10.06 19:25,close,2333,0.01,1.65521,12.35,18779.55,EURAUD
4669,2009.10.06 19:27,close,2334,0.01,0.91276,5.95,18785.50,AUDCHF
4670,2009.10.06 19:29,close,2335,0.01,0.94151,-2.03,18783.47,AUDCAD
4671,2009.10.06 19:29,close,2336,0.01,78.9820,3.67,18787.14,AUDJPY
4672,2009.10.06 19:29,close,2332,0.01,1.21274,7.82,18794.96,AUDNZD
4673,2009.10.06 19:29,close,2331,0.01,1.78869,22.21,18817.17,GBPAUD
4674,2009.10.06 19:30,close,2337,0.01,0.88943,6.77,18823.94,AUDUSD
4675,2009.10.13 16:25,sell,2338,0.01,1.63787,,,EURAUD
4676,2009.10.13 16:25,sell,2339,0.01,1.74884,,,GBPAUD
4677,2009.10.13 16:29,buy,2340,0.01,0.93535,,,AUDCAD
4678,2009.10.13 16:29,buy,2341,0.01,0.92801,,,AUDCHF
4679,2009.10.13 16:29,buy,2342,0.01,81.1550,,,AUDJPY
4680,2009.10.13 16:29,buy,2343,0.01,1.23311,,,AUDNZD
4681,2009.10.13 16:30,buy,2344,0.01,0.90538,,,AUDUSD
4682,2009.10.13 20:25,sell,2345,0.01,1.63826,,,EURAUD
4683,2009.10.13 20:29,buy,2346,0.01,81.2300,,,AUDJPY
4684,2009.10.13 20:30,buy,2347,0.01,0.93635,,,AUDCAD
4685,2009.10.13 20:30,buy,2348,0.01,0.92626,,,AUDCHF
4686,2009.10.13 20:30,buy,2349,0.01,1.23308,,,AUDNZD
4687,2009.10.13 20:30,buy,2350,0.01,0.90477,,,AUDUSD
4688,2009.10.13 20:30,sell,2351,0.01,1.75717,,,GBPAUD
4689,2009.10.14 06:55,close,2346,0.01,81.2800,0.57,18824.51,AUDJPY
4690,2009.10.14 06:55,close,2342,0.01,81.2800,1.33,18825.84,AUDJPY
4691,2009.10.14 06:58,close,2348,0.01,0.93118,5.32,18831.16,AUDCHF
4692,2009.10.14 06:58,close,2341,0.01,0.93118,3.45,18834.61,AUDCHF
4693,2009.10.14 06:59,close,2347,0.01,0.93846,2.13,18836.74,AUDCAD
4694,2009.10.14 06:59,close,2340,0.01,0.93846,3.12,18839.86,AUDCAD
4695,2009.10.14 06:59,close,2349,0.01,1.23201,-0.92,18838.94,AUDNZD
4696,2009.10.14 06:59,close,2343,0.01,1.23201,-0.94,18838.00,AUDNZD
4697,2009.10.14 06:59,close,2345,0.01,1.62950,9.12,18847.12,EURAUD
4698,2009.10.14 06:59,close,2338,0.01,1.62950,8.72,18855.84,EURAUD
4699,2009.10.14 06:59,close,2351,0.01,1.74632,11.28,18867.12,GBPAUD
4700,2009.10.14 06:59,close,2339,0.01,1.74632,2.69,18869.81,GBPAUD
4701,2009.10.14 07:00,close,2350,0.01,0.91325,8.54,18878.35,AUDUSD
4702,2009.10.14 07:00,close,2344,0.01,0.91325,7.94,18886.29,AUDUSD
4703,2009.10.16 14:55,sell,2352,0.01,1.78253,,,GBPAUD
4704,2009.10.16 14:56,sell,2353,0.01,1.62457,,,EURAUD
4705,2009.10.16 14:59,buy,2354,0.01,0.95330,,,AUDCAD
4706,2009.10.16 14:59,buy,2355,0.01,0.93460,,,AUDCHF
4707,2009.10.16 14:59,buy,2356,0.01,83.3930,,,AUDJPY
4708,2009.10.16 14:59,buy,2357,0.01,1.24008,,,AUDNZD
4709,2009.10.16 15:00,buy,2358,0.01,0.91523,,,AUDUSD
4710,2009.10.19 00:55,buy,2359,0.01,0.93194,,,AUDCHF
4711,2009.10.19 00:56,sell,2360,0.01,1.62759,,,EURAUD
4712,2009.10.19 00:56,sell,2361,0.01,1.78443,,,GBPAUD
4713,2009.10.19 00:59,buy,2362,0.01,0.95079,,,AUDCAD
4714,2009.10.19 00:59,buy,2363,0.01,83.4580,,,AUDJPY
4715,2009.10.19 00:59,buy,2364,0.01,1.23572,,,AUDNZD
4716,2009.10.19 01:00,buy,2365,0.01,0.91632,,,AUDUSD
4717,2009.10.19 02:55,sell,2366,0.01,1.62657,,,EURAUD
4718,2009.10.19 02:59,buy,2367,0.01,0.93278,,,AUDCHF
4719,2009.10.19 02:59,buy,2368,0.01,1.23520,,,AUDNZD
4720,2009.10.19 03:00,buy,2369,0.01,0.95014,,,AUDCAD
4721,2009.10.19 03:00,buy,2370,0.01,83.0130,,,AUDJPY
4722,2009.10.19 03:00,buy,2371,0.01,0.91268,,,AUDUSD
4723,2009.10.19 03:00,sell,2372,0.01,1.78614,,,GBPAUD
4724,2009.10.19 10:25,close,2372,0.01,1.76563,21.13,18907.42,GBPAUD
4725,2009.10.19 10:25,close,2361,0.01,1.76563,19.37,18926.79,GBPAUD
4726,2009.10.19 10:25,close,2352,0.01,1.76563,17.51,18944.30,GBPAUD
4727,2009.10.19 10:29,close,2369,0.01,0.95440,4.23,18948.53,AUDCAD
4728,2009.10.19 10:29,close,2362,0.01,0.95440,3.59,18952.12,AUDCAD
4729,2009.10.19 10:29,close,2354,0.01,0.95440,1.14,18953.26,AUDCAD
4730,2009.10.19 10:29,close,2367,0.01,0.93458,1.93,18955.19,AUDCHF
4731,2009.10.19 10:29,close,2359,0.01,0.93458,2.82,18958.01,AUDCHF
4732,2009.10.19 10:29,close,2355,0.01,0.93458,0.04,18958.05,AUDCHF
4733,2009.10.19 10:29,close,2370,0.01,83.3910,3.81,18961.86,AUDJPY
4734,2009.10.19 10:29,close,2363,0.01,83.3910,-0.68,18961.18,AUDJPY
4735,2009.10.19 10:29,close,2356,0.01,83.3910,0.05,18961.23,AUDJPY
4736,2009.10.19 10:29,close,2368,0.01,1.23215,-2.61,18958.62,AUDNZD
4737,2009.10.19 10:29,close,2364,0.01,1.23215,-3.05,18955.57,AUDNZD
4738,2009.10.19 10:29,close,2357,0.01,1.23215,-6.77,18948.80,AUDNZD
4739,2009.10.19 10:29,close,2366,0.01,1.62081,5.94,18954.74,EURAUD
4740,2009.10.19 10:29,close,2360,0.01,1.62081,6.99,18961.73,EURAUD
4741,2009.10.19 10:29,close,2353,0.01,1.62081,3.98,18965.71,EURAUD
4742,2009.10.19 10:30,close,2371,0.01,0.92248,9.80,18975.51,AUDUSD
4743,2009.10.19 10:30,close,2365,0.01,0.92248,6.16,18981.67,AUDUSD
4744,2009.10.19 10:30,close,2358,0.01,0.92248,7.32,18988.99,AUDUSD
4745,2009.10.20 10:25,sell,2373,0.01,1.76758,,,GBPAUD
4746,2009.10.20 10:26,sell,2374,0.01,1.61555,,,EURAUD
4747,2009.10.20 10:30,buy,2375,0.01,0.95441,,,AUDCAD
4748,2009.10.20 10:30,buy,2376,0.01,0.93627,,,AUDCHF
4749,2009.10.20 10:30,buy,2377,0.01,83.5860,,,AUDJPY
4750,2009.10.20 10:30,buy,2378,0.01,1.22816,,,AUDNZD
4751,2009.10.20 10:30,buy,2379,0.01,0.92628,,,AUDUSD
4752,2009.10.21 19:55,close,2374,0.01,1.61400,1.69,18990.68,EURAUD
4753,2009.10.21 19:57,close,2376,0.01,0.93519,-1.09,18989.59,AUDCHF
4754,2009.10.21 20:00,close,2375,0.01,0.96771,13.23,19002.82,AUDCAD
4755,2009.10.21 20:00,close,2377,0.01,84.7610,11.92,19014.74,AUDJPY
4756,2009.10.21 20:00,close,2378,0.01,1.22058,-6.47,19008.27,AUDNZD
4757,2009.10.21 20:00,close,2379,0.01,0.93178,5.57,19013.84,AUDUSD
4758,2009.10.21 20:00,close,2373,0.01,1.78255,-15.33,18998.51,GBPAUD
4759,2009.10.22 08:55,sell,2380,0.01,1.62565,,,EURAUD
4760,2009.10.22 08:59,buy,2381,0.01,0.96767,,,AUDCAD
4761,2009.10.22 08:59,buy,2382,0.01,0.92975,,,AUDCHF
4762,2009.10.22 08:59,buy,2383,0.01,84.3290,,,AUDJPY
4763,2009.10.22 08:59,buy,2384,0.01,1.22598,,,AUDNZD
4764,2009.10.22 08:59,sell,2385,0.01,1.79976,,,GBPAUD
4765,2009.10.22 09:00,buy,2386,0.01,0.92175,,,AUDUSD
4766,2009.10.23 02:25,close,2385,0.01,1.79325,6.81,19005.32,GBPAUD
4767,2009.10.23 02:26,close,2380,0.01,1.62020,5.72,19011.04,EURAUD
4768,2009.10.23 02:28,close,2383,0.01,84.9170,6.00,19017.04,AUDJPY
4769,2009.10.23 02:29,close,2382,0.01,0.93179,2.25,19019.29,AUDCHF
4770,2009.10.23 02:29,close,2384,0.01,1.22228,-3.16,19016.13,AUDNZD
4771,2009.10.23 02:30,close,2381,0.01,0.97113,3.47,19019.60,AUDCAD
4772,2009.10.23 02:30,close,2386,0.01,0.92840,6.72,19026.32,AUDUSD
4773,2009.10.23 21:55,sell,2387,0.01,1.62605,,,EURAUD
4774,2009.10.23 22:00,buy,2388,0.01,0.97018,,,AUDCAD
4775,2009.10.23 22:00,buy,2389,0.01,0.93098,,,AUDCHF
4776,2009.10.23 22:00,buy,2390,0.01,84.9040,,,AUDJPY
4777,2009.10.23 22:00,buy,2391,0.01,1.22234,,,AUDNZD
4778,2009.10.23 22:00,buy,2392,0.01,0.92220,,,AUDUSD
4779,2009.10.23 22:00,sell,2393,0.01,1.76762,,,GBPAUD
4780,2009.10.26 03:25,close,2387,0.01,1.62445,1.75,19028.07,EURAUD
4781,2009.10.26 03:27,close,2389,0.01,0.93162,0.74,19028.81,AUDCHF
4782,2009.10.26 03:30,close,2388,0.01,0.97272,2.56,19031.37,AUDCAD
4783,2009.10.26 03:30,close,2390,0.01,84.8930,-0.04,19031.33,AUDJPY
4784,2009.10.26 03:30,close,2391,0.01,1.22418,1.57,19032.90,AUDNZD
4785,2009.10.26 03:30,close,2392,0.01,0.92642,4.29,19037.19,AUDUSD
4786,2009.10.26 03:30,close,2393,0.01,1.75859,9.41,19046.60,GBPAUD
4787,2009.10.26 20:55,sell,2394,0.01,1.62494,,,EURAUD
4788,2009.10.26 20:59,buy,2395,0.01,0.97590,,,AUDCAD
4789,2009.10.26 20:59,buy,2396,0.01,0.93169,,,AUDCHF
4790,2009.10.26 21:00,buy,2397,0.01,84.3440,,,AUDJPY
4791,2009.10.26 21:00,buy,2398,0.01,1.22362,,,AUDNZD
4792,2009.10.26 21:00,buy,2399,0.01,0.91476,,,AUDUSD
4793,2009.10.26 21:00,sell,2400,0.01,1.78385,,,GBPAUD
4794,2009.10.28 06:55,buy,2401,0.01,0.92920,,,AUDCHF
4795,2009.10.28 06:55,buy,2402,0.01,0.92922,,,AUDCHF
4796,2009.10.28 06:57,sell,2403,0.01,1.62733,,,EURAUD
4797,2009.10.28 06:57,sell,2404,0.01,1.62731,,,EURAUD
4798,2009.10.28 06:59,buy,2405,0.01,0.97209,,,AUDCAD
4799,2009.10.28 06:59,buy,2406,0.01,0.97207,,,AUDCAD
4800,2009.10.28 06:59,buy,2407,0.01,83.1270,,,AUDJPY
4801,2009.10.28 06:59,buy,2408,0.01,83.1260,,,AUDJPY
4802,2009.10.28 06:59,buy,2409,0.01,1.23131,,,AUDNZD
4803,2009.10.28 06:59,sell,2410,0.01,1.79560,,,GBPAUD
4804,2009.10.28 06:59,sell,2411,0.01,1.79559,,,GBPAUD
4805,2009.10.28 07:00,buy,2412,0.01,1.23129,,,AUDNZD
4806,2009.10.28 07:00,buy,2413,0.01,0.91096,,,AUDUSD
4807,2009.10.28 07:00,buy,2414,0.01,0.91095,,,AUDUSD
4808,2009.10.28 13:55,sell,2415,0.01,1.63208,,,EURAUD
4809,2009.10.28 13:55,sell,2416,0.01,1.80129,,,GBPAUD
4810,2009.10.28 13:56,sell,2417,0.01,1.63188,,,EURAUD
4811,2009.10.28 13:56,sell,2418,0.01,1.80096,,,GBPAUD
4812,2009.10.28 13:58,buy,2419,0.01,0.92608,,,AUDCHF
4813,2009.10.28 13:59,buy,2420,0.01,0.97210,,,AUDCAD
4814,2009.10.28 13:59,buy,2421,0.01,0.92630,,,AUDCHF
4815,2009.10.28 13:59,buy,2422,0.01,1.23234,,,AUDNZD
4816,2009.10.28 14:00,buy,2423,0.01,0.97214,,,AUDCAD
4817,2009.10.28 14:00,buy,2424,0.01,82.7680,,,AUDJPY
4818,2009.10.28 14:00,buy,2425,0.01,0.90749,,,AUDUSD
4819,2009.10.28 14:01,buy,2426,0.01,82.7500,,,AUDJPY
4820,2009.10.28 14:01,buy,2427,0.01,1.23204,,,AUDNZD
4821,2009.10.28 14:01,buy,2428,0.01,0.90687,,,AUDUSD
4822,2009.10.28 21:31,sell,2429,0.01,1.63846,,,EURAUD
4823,2009.10.28 21:31,sell,2430,0.01,1.63845,,,EURAUD
4824,2009.10.28 21:31,sell,2431,0.01,1.63847,,,EURAUD
4825,2009.10.28 21:35,sell,2432,0.01,1.82223,,,GBPAUD
4826,2009.10.28 21:35,sell,2433,0.01,1.82227,,,GBPAUD
4827,2009.10.28 21:36,buy,2434,0.01,0.97024,,,AUDCAD
4828,2009.10.28 21:36,buy,2435,0.01,0.97027,,,AUDCAD
4829,2009.10.28 21:36,buy,2436,0.01,0.97031,,,AUDCAD
4830,2009.10.28 21:36,buy,2437,0.01,0.92205,,,AUDCHF
4831,2009.10.28 21:36,buy,2438,0.01,0.92210,,,AUDCHF
4832,2009.10.28 21:36,buy,2439,0.01,0.92215,,,AUDCHF
4833,2009.10.28 21:36,buy,2440,0.01,81.5050,,,AUDJPY
4834,2009.10.28 21:36,buy,2441,0.01,81.5100,,,AUDJPY
4835,2009.10.28 21:36,buy,2442,0.01,81.5150,,,AUDJPY
4836,2009.10.28 21:36,buy,2443,0.01,1.24025,,,AUDNZD
4837,2009.10.28 21:36,buy,2444,0.01,1.24019,,,AUDNZD
4838,2009.10.28 21:36,buy,2445,0.01,1.24020,,,AUDNZD
4839,2009.10.28 21:36,buy,2446,0.02,0.89823,,,AUDUSD
4840,2009.10.28 21:36,buy,2447,0.01,0.89829,,,AUDUSD
4841,2009.10.28 21:36,sell,2448,0.01,1.82217,,,GBPAUD
4842,2009.10.28 22:20,buy,2449,0.01,81.3350,,,AUDJPY
4843,2009.10.28 22:20,sell,2450,0.01,1.63880,,,EURAUD
4844,2009.10.28 22:22,buy,2451,0.01,0.92171,,,AUDCHF
4845,2009.10.28 22:23,buy,2452,0.01,1.24454,,,AUDNZD
4846,2009.10.28 22:23,sell,2453,0.01,1.82425,,,GBPAUD
4847,2009.10.28 22:24,buy,2454,0.01,0.97042,,,AUDCAD
4848,2009.10.28 22:24,buy,2455,0.01,0.89778,,,AUDUSD
4849,2009.10.29 12:58,close,2450,0.01,1.63067,8.67,19055.27,EURAUD
4850,2009.10.29 12:58,close,2431,0.01,1.63067,8.33,19063.60,EURAUD
4851,2009.10.29 12:58,close,2430,0.01,1.63067,8.31,19071.91,EURAUD
4852,2009.10.29 12:58,close,2429,0.01,1.63067,8.32,19080.23,EURAUD
4853,2009.10.29 12:58,close,2417,0.01,1.63067,1.54,19081.77,EURAUD
4854,2009.10.29 12:58,close,2415,0.01,1.63067,1.75,19083.52,EURAUD
4855,2009.10.29 12:58,close,2404,0.01,1.63067,-3.17,19080.35,EURAUD
4856,2009.10.29 12:58,close,2403,0.01,1.63067,-3.15,19077.20,EURAUD
4857,2009.10.29 12:58,close,2394,0.01,1.63067,-5.41,19071.79,EURAUD
4858,2009.10.29 13:03,close,2454,0.01,0.97515,4.82,19076.61,AUDCAD
4859,2009.10.29 13:03,close,2436,0.01,0.97515,4.93,19081.54,AUDCAD
4860,2009.10.29 13:03,close,2435,0.01,0.97515,4.97,19086.51,AUDCAD
4861,2009.10.29 13:03,close,2434,0.01,0.97515,5.00,19091.51,AUDCAD
4862,2009.10.29 13:03,close,2423,0.01,0.97515,3.12,19094.63,AUDCAD
4863,2009.10.29 13:03,close,2420,0.01,0.97515,3.16,19097.79,AUDCAD
4864,2009.10.29 13:03,close,2406,0.01,0.97515,3.19,19100.98,AUDCAD
4865,2009.10.29 13:03,close,2405,0.01,0.97515,3.17,19104.15,AUDCAD
4866,2009.10.29 13:03,close,2395,0.01,0.97515,-0.53,19103.62,AUDCAD
4867,2009.10.29 13:03,close,2451,0.01,0.92704,5.89,19109.51,AUDCHF
4868,2009.10.29 13:03,close,2439,0.01,0.92704,5.42,19114.93,AUDCHF
4869,2009.10.29 13:03,close,2438,0.01,0.92704,5.47,19120.40,AUDCHF
4870,2009.10.29 13:03,close,2437,0.01,0.92704,5.53,19125.93,AUDCHF
4871,2009.10.29 13:03,close,2421,0.01,0.92704,0.98,19126.91,AUDCHF
4872,2009.10.29 13:03,close,2419,0.01,0.92704,1.22,19128.13,AUDCHF
4873,2009.10.29 13:03,close,2402,0.01,0.92704,-2.14,19125.99,AUDCHF
4874,2009.10.29 13:03,close,2401,0.01,0.92704,-2.12,19123.87,AUDCHF
4875,2009.10.29 13:03,close,2396,0.01,0.92704,-4.65,19119.22,AUDCHF
4876,2009.10.29 13:03,close,2449,0.01,82.0540,7.48,19126.70,AUDJPY
4877,2009.10.29 13:03,close,2442,0.01,82.0540,5.66,19132.36,AUDJPY
4878,2009.10.29 13:03,close,2441,0.01,82.0540,5.71,19138.07,AUDJPY
4879,2009.10.29 13:03,close,2440,0.01,82.0540,5.76,19143.83,AUDJPY
4880,2009.10.29 13:03,close,2426,0.01,82.0540,-6.80,19137.03,AUDJPY
4881,2009.10.29 13:03,close,2424,0.01,82.0540,-6.98,19130.05,AUDJPY
4882,2009.10.29 13:03,close,2408,0.01,82.0540,-10.59,19119.46,AUDJPY
4883,2009.10.29 13:03,close,2407,0.01,82.0540,-10.60,19108.86,AUDJPY
4884,2009.10.29 13:03,close,2397,0.01,82.0540,-22.73,19086.13,AUDJPY
4885,2009.10.29 13:03,close,2452,0.01,1.24669,1.82,19087.95,AUDNZD
4886,2009.10.29 13:03,close,2445,0.01,1.24669,5.52,19093.47,AUDNZD
4887,2009.10.29 13:03,close,2444,0.01,1.24669,5.53,19099.00,AUDNZD
4888,2009.10.29 13:03,close,2443,0.01,1.24669,5.48,19104.48,AUDNZD
4889,2009.10.29 13:03,close,2427,0.01,1.24669,12.49,19116.97,AUDNZD
4890,2009.10.29 13:03,close,2422,0.01,1.24669,12.23,19129.20,AUDNZD
4891,2009.10.29 13:03,close,2412,0.01,1.24669,13.13,19142.33,AUDNZD
4892,2009.10.29 13:03,close,2409,0.01,1.24669,13.11,19155.44,AUDNZD
4893,2009.10.29 13:03,close,2398,0.01,1.24669,19.68,19175.12,AUDNZD
4894,2009.10.29 13:03,close,2455,0.01,0.90408,6.50,19181.62,AUDUSD
4895,2009.10.29 13:03,close,2447,0.01,0.90408,5.99,19187.61,AUDUSD
4896,2009.10.29 13:03,close,2446,0.02,0.90408,12.09,19199.70,AUDUSD
4897,2009.10.29 13:03,close,2428,0.01,0.90408,-2.60,19197.10,AUDUSD
4898,2009.10.29 13:03,close,2425,0.01,0.90408,-3.22,19193.88,AUDUSD
4899,2009.10.29 13:03,close,2414,0.01,0.90408,-6.67,19187.21,AUDUSD
4900,2009.10.29 13:03,close,2413,0.01,0.90408,-6.68,19180.53,AUDUSD
4901,2009.10.29 13:03,close,2399,0.01,0.90408,-10.36,19170.17,AUDUSD
4902,2009.10.29 16:35,close,2453,0.01,1.80786,17.19,19187.36,GBPAUD
4903,2009.10.29 16:35,close,2448,0.01,1.80786,15.04,19202.40,GBPAUD
4904,2009.10.29 16:35,close,2433,0.01,1.80786,15.15,19217.55,GBPAUD
4905,2009.10.29 16:35,close,2432,0.01,1.80786,15.11,19232.66,GBPAUD
4906,2009.10.29 16:35,close,2418,0.01,1.80786,-6.81,19225.85,GBPAUD
4907,2009.10.29 16:35,close,2416,0.01,1.80786,-6.47,19219.38,GBPAUD
4908,2009.10.29 16:35,close,2411,0.01,1.80786,-12.34,19207.04,GBPAUD
4909,2009.10.29 16:35,close,2410,0.01,1.80786,-12.33,19194.71,GBPAUD
4910,2009.10.29 16:35,close,2400,0.01,1.80786,-24.25,19170.46,GBPAUD
4911,2009.11.02 01:25,sell,2456,0.01,1.63757,,,EURAUD
4912,2009.11.02 01:29,buy,2457,0.01,0.92233,,,AUDCHF
4913,2009.11.02 01:29,buy,2458,0.01,80.8460,,,AUDJPY
4914,2009.11.02 01:29,sell,2459,0.01,1.82681,,,GBPAUD
4915,2009.11.02 01:30,buy,2460,0.01,0.97224,,,AUDCAD
4916,2009.11.02 01:30,buy,2461,0.01,1.25442,,,AUDNZD
4917,2009.11.02 01:30,buy,2462,0.01,0.89906,,,AUDUSD
4918,2009.11.02 10:25,close,2459,0.01,1.80482,22.66,19193.12,GBPAUD
4919,2009.11.02 10:28,close,2456,0.01,1.63020,7.59,19200.71,EURAUD
4920,2009.11.02 10:29,close,2460,0.01,0.97879,6.50,19207.21,AUDCAD
4921,2009.11.02 10:29,close,2457,0.01,0.92585,3.77,19210.98,AUDCHF
4922,2009.11.02 10:29,close,2458,0.01,81.7150,8.77,19219.75,AUDJPY
4923,2009.11.02 10:29,close,2461,0.01,1.25596,1.32,19221.07,AUDNZD
4924,2009.11.02 10:30,close,2462,0.01,0.90597,6.91,19227.98,AUDUSD
4925,2009.11.03 06:55,buy,2463,0.01,0.92220,,,AUDCHF
4926,2009.11.03 06:57,sell,2464,0.01,1.63767,,,EURAUD
4927,2009.11.03 06:59,buy,2465,0.01,0.97273,,,AUDCAD
4928,2009.11.03 06:59,buy,2466,0.01,81.5490,,,AUDJPY
4929,2009.11.03 06:59,buy,2467,0.01,1.24985,,,AUDNZD
4930,2009.11.03 06:59,sell,2468,0.01,1.81380,,,GBPAUD
4931,2009.11.03 07:00,buy,2469,0.01,0.90329,,,AUDUSD
4932,2009.11.03 11:29,sell,2470,0.01,1.64040,,,EURAUD
4933,2009.11.03 11:29,sell,2471,0.01,1.64039,,,EURAUD
4934,2009.11.03 11:34,buy,2472,0.01,0.96775,,,AUDCAD
4935,2009.11.03 11:34,buy,2473,0.01,0.96777,,,AUDCAD
4936,2009.11.03 11:34,buy,2474,0.01,0.92219,,,AUDCHF
4937,2009.11.03 11:34,buy,2475,0.01,0.92221,,,AUDCHF
4938,2009.11.03 11:34,buy,2476,0.01,80.5340,,,AUDJPY
4939,2009.11.03 11:34,buy,2477,0.01,80.5390,,,AUDJPY
4940,2009.11.03 11:34,buy,2478,0.01,1.25518,,,AUDNZD
4941,2009.11.03 11:34,buy,2479,0.01,1.25517,,,AUDNZD
4942,2009.11.03 11:34,buy,2480,0.01,0.89427,,,AUDUSD
4943,2009.11.03 11:34,buy,2481,0.01,0.89432,,,AUDUSD
4944,2009.11.03 11:34,sell,2482,0.01,1.82278,,,GBPAUD
4945,2009.11.03 11:34,sell,2483,0.01,1.82279,,,GBPAUD
4946,2009.11.04 16:25,close,2471,0.01,1.62771,13.17,19241.15,EURAUD
4947,2009.11.04 16:25,close,2470,0.01,1.62771,13.18,19254.33,EURAUD
4948,2009.11.04 16:25,close,2464,0.01,1.62771,10.37,19264.70,EURAUD
4949,2009.11.04 16:25,close,2483,0.01,1.81677,6.30,19271.00,GBPAUD
4950,2009.11.04 16:25,close,2482,0.01,1.81677,6.29,19277.29,GBPAUD
4951,2009.11.04 16:25,close,2468,0.01,1.81677,-2.96,19274.33,GBPAUD
4952,2009.11.04 16:29,close,2473,0.01,0.96655,-1.17,19273.16,AUDCAD
4953,2009.11.04 16:29,close,2472,0.01,0.96655,-1.15,19272.01,AUDCAD
4954,2009.11.04 16:29,close,2465,0.01,0.96655,-6.09,19265.92,AUDCAD
4955,2009.11.04 16:29,close,2475,0.01,0.92761,5.84,19271.76,AUDCHF
4956,2009.11.04 16:29,close,2474,0.01,0.92761,5.86,19277.62,AUDCHF
4957,2009.11.04 16:29,close,2463,0.01,0.92761,5.85,19283.47,AUDCHF
4958,2009.11.04 16:29,close,2477,0.01,82.5380,20.23,19303.70,AUDJPY
4959,2009.11.04 16:29,close,2476,0.01,82.5380,20.28,19323.98,AUDJPY
4960,2009.11.04 16:29,close,2466,0.01,82.5380,10.05,19334.03,AUDJPY
4961,2009.11.04 16:30,close,2479,0.01,1.25657,1.20,19335.23,AUDNZD
4962,2009.11.04 16:30,close,2478,0.01,1.25657,1.19,19336.42,AUDNZD
4963,2009.11.04 16:30,close,2467,0.01,1.25657,5.74,19342.16,AUDNZD
4964,2009.11.04 16:30,close,2481,0.01,0.91070,16.45,19358.61,AUDUSD
4965,2009.11.04 16:30,close,2480,0.01,0.91070,16.50,19375.11,AUDUSD
4966,2009.11.04 16:30,close,2469,0.01,0.91070,7.48,19382.59,AUDUSD
4967,2009.11.05 06:25,buy,2484,0.01,0.92115,,,AUDCHF
4968,2009.11.05 06:29,buy,2485,0.01,0.96523,,,AUDCAD
4969,2009.11.05 06:29,buy,2486,0.01,1.25862,,,AUDNZD
4970,2009.11.05 06:29,sell,2487,0.01,1.82367,,,GBPAUD
4971,2009.11.05 06:30,buy,2488,0.01,81.9000,,,AUDJPY
4972,2009.11.05 06:30,buy,2489,0.01,0.90572,,,AUDUSD
4973,2009.11.05 06:30,sell,2490,0.01,1.63828,,,EURAUD
4974,2009.11.06 07:25,close,2484,0.01,0.92672,6.02,19388.61,AUDCHF
4975,2009.11.06 07:25,close,2490,0.01,1.63046,8.15,19396.76,EURAUD
4976,2009.11.06 07:28,close,2487,0.01,1.81862,5.30,19402.06,GBPAUD
4977,2009.11.06 07:29,close,2485,0.01,0.97225,7.00,19409.06,AUDCAD
4978,2009.11.06 07:29,close,2488,0.01,82.6650,7.79,19416.85,AUDJPY
4979,2009.11.06 07:29,close,2486,0.01,1.26453,5.04,19421.89,AUDNZD
4980,2009.11.06 07:30,close,2489,0.01,0.91279,7.14,19429.03,AUDUSD
4981,2009.11.12 18:45,sell,2491,0.01,1.78979,,,GBPAUD
4982,2009.11.12 18:49,buy,2492,0.01,0.93973,,,AUDCHF
4983,2009.11.12 18:50,buy,2493,0.01,0.97267,,,AUDCAD
4984,2009.11.12 18:50,buy,2494,0.01,83.6520,,,AUDJPY
4985,2009.11.12 18:50,buy,2495,0.01,1.26082,,,AUDNZD
4986,2009.11.12 18:50,buy,2496,0.01,0.92512,,,AUDUSD
4987,2009.11.12 18:50,sell,2497,0.01,1.60710,,,EURAUD
4988,2009.11.12 21:55,sell,2498,0.01,1.60872,,,EURAUD
4989,2009.11.12 21:55,sell,2499,0.01,1.79743,,,GBPAUD
4990,2009.11.12 21:59,buy,2500,0.01,0.93919,,,AUDCHF
4991,2009.11.12 22:00,buy,2501,0.01,0.97444,,,AUDCAD
4992,2009.11.12 22:00,buy,2502,0.01,83.4340,,,AUDJPY
4993,2009.11.12 22:00,buy,2503,0.01,1.26027,,,AUDNZD
4994,2009.11.12 22:00,buy,2504,0.01,0.92265,,,AUDUSD
4995,2009.11.13 22:25,close,2502,0.01,83.7300,3.05,19432.08,AUDJPY
4996,2009.11.13 22:25,close,2494,0.01,83.7300,0.86,19432.94,AUDJPY
4997,2009.11.13 22:25,close,2503,0.01,1.25319,-6.05,19426.89,AUDNZD
4998,2009.11.13 22:25,close,2495,0.01,1.25319,-6.52,19420.37,AUDNZD
4999,2009.11.13 22:29,close,2498,0.01,1.59774,11.42,19431.79,EURAUD
5000,2009.11.13 22:29,close,2497,0.01,1.59774,9.75,19441.54,EURAUD
5001,2009.11.13 22:29,close,2499,0.01,1.78704,10.80,19452.34,GBPAUD
5002,2009.11.13 22:29,close,2491,0.01,1.78704,2.93,19455.27,GBPAUD
5003,2009.11.13 22:30,close,2501,0.01,0.98000,5.56,19460.83,AUDCAD
5004,2009.11.13 22:30,close,2493,0.01,0.98000,7.31,19468.14,AUDCAD
5005,2009.11.13 22:30,close,2500,0.01,0.94419,5.40,19473.54,AUDCHF
5006,2009.11.13 22:30,close,2492,0.01,0.94419,4.83,19478.37,AUDCHF
5007,2009.11.13 22:30,close,2504,0.01,0.93338,10.80,19489.17,AUDUSD
5008,2009.11.13 22:30,close,2496,0.01,0.93338,8.32,19497.49,AUDUSD
5009,2009.11.16 10:25,sell,2505,0.01,1.78756,,,GBPAUD
5010,2009.11.16 10:27,sell,2506,0.01,1.60415,,,EURAUD
5011,2009.11.16 10:29,buy,2507,0.01,0.97697,,,AUDCAD
5012,2009.11.16 10:29,buy,2508,0.01,0.94091,,,AUDCHF
5013,2009.11.16 10:29,buy,2509,0.01,83.5420,,,AUDJPY
5014,2009.11.16 10:30,buy,2510,0.01,1.25535,,,AUDNZD
5015,2009.11.16 10:30,buy,2511,0.01,0.93361,,,AUDUSD
5016,2009.11.17 04:25,sell,2512,0.01,1.60092,,,EURAUD
5017,2009.11.17 04:26,buy,2513,0.01,0.94277,,,AUDCHF
5018,2009.11.17 04:27,buy,2514,0.01,83.2210,,,AUDJPY
5019,2009.11.17 04:27,buy,2515,0.01,1.24860,,,AUDNZD
5020,2009.11.17 04:27,sell,2516,0.01,1.79867,,,GBPAUD
5021,2009.11.17 04:28,buy,2517,0.01,0.97975,,,AUDCAD
5022,2009.11.17 04:30,buy,2518,0.01,0.93415,,,AUDUSD
5023,2009.11.17 07:25,sell,2519,0.01,1.80150,,,GBPAUD
5024,2009.11.17 07:26,sell,2520,0.01,1.60182,,,EURAUD
5025,2009.11.17 07:27,buy,2521,0.01,0.94241,,,AUDCHF
5026,2009.11.17 07:29,buy,2522,0.01,0.97912,,,AUDCAD
5027,2009.11.17 07:29,buy,2523,0.01,83.0830,,,AUDJPY
5028,2009.11.17 07:29,buy,2524,0.01,1.24910,,,AUDNZD
5029,2009.11.17 07:30,buy,2525,0.01,0.93278,,,AUDUSD
5030,2009.11.17 12:25,sell,2526,0.01,1.80969,,,GBPAUD
5031,2009.11.17 12:25,sell,2527,0.01,1.80968,,,GBPAUD
5032,2009.11.17 12:29,buy,2528,0.01,0.98089,,,AUDCAD
5033,2009.11.17 12:29,buy,2529,0.01,0.94112,,,AUDCHF
5034,2009.11.17 12:29,buy,2530,0.01,82.7110,,,AUDJPY
5035,2009.11.17 12:29,buy,2531,0.01,1.24631,,,AUDNZD
5036,2009.11.17 12:30,buy,2532,0.01,0.98093,,,AUDCAD
5037,2009.11.17 12:30,buy,2533,0.01,0.94111,,,AUDCHF
5038,2009.11.17 12:30,buy,2534,0.01,82.7120,,,AUDJPY
5039,2009.11.17 12:30,buy,2535,0.01,1.24632,,,AUDNZD
5040,2009.11.17 12:30,buy,2536,0.01,0.92829,,,AUDUSD
5041,2009.11.17 12:30,buy,2537,0.01,0.92830,,,AUDUSD
5042,2009.11.17 12:30,sell,2538,0.01,1.60570,,,EURAUD
5043,2009.11.17 12:30,sell,2539,0.01,1.60568,,,EURAUD
5044,2009.11.19 10:55,sell,2540,0.01,1.81406,,,GBPAUD
5045,2009.11.19 10:55,sell,2541,0.01,1.81408,,,GBPAUD
5046,2009.11.19 10:59,buy,2542,0.01,0.93703,,,AUDCHF
5047,2009.11.19 10:59,buy,2543,0.01,0.93702,,,AUDCHF
5048,2009.11.19 10:59,buy,2544,0.01,81.8270,,,AUDJPY
5049,2009.11.19 10:59,buy,2545,0.01,81.8290,,,AUDJPY
5050,2009.11.19 10:59,buy,2546,0.01,1.25580,,,AUDNZD
5051,2009.11.19 11:00,buy,2547,0.01,0.97649,,,AUDCAD
5052,2009.11.19 11:00,buy,2548,0.01,0.97647,,,AUDCAD
5053,2009.11.19 11:00,buy,2549,0.01,1.25579,,,AUDNZD
5054,2009.11.19 11:00,buy,2550,0.01,0.92020,,,AUDUSD
5055,2009.11.19 11:00,buy,2551,0.01,0.92021,,,AUDUSD
5056,2009.11.19 11:00,sell,2552,0.01,1.61532,,,EURAUD
5057,2009.11.19 11:00,sell,2553,0.01,1.61536,,,EURAUD
5058,2009.11.19 11:18,sell,2554,0.01,1.81401,,,GBPAUD
5059,2009.11.19 11:22,buy,2555,0.01,0.97545,,,AUDCAD
5060,2009.11.19 11:22,buy,2556,0.01,0.93669,,,AUDCHF
5061,2009.11.19 11:22,buy,2557,0.01,81.8050,,,AUDJPY
5062,2009.11.19 11:22,sell,2558,0.01,1.61604,,,EURAUD
5063,2009.11.19 11:23,buy,2559,0.01,1.25553,,,AUDNZD
5064,2009.11.19 11:23,buy,2560,0.01,0.91991,,,AUDUSD
5065,2009.11.19 14:13,sell,2561,0.01,1.81256,,,GBPAUD
5066,2009.11.19 14:16,sell,2562,0.01,1.61939,,,EURAUD
5067,2009.11.19 14:18,buy,2563,0.01,0.97439,,,AUDCAD
5068,2009.11.19 14:18,buy,2564,0.01,0.93424,,,AUDCHF
5069,2009.11.19 14:18,buy,2565,0.01,81.5010,,,AUDJPY
5070,2009.11.19 14:18,buy,2566,0.01,1.25684,,,AUDNZD
5071,2009.11.19 14:18,buy,2567,0.01,0.91774,,,AUDUSD
5072,2009.11.19 16:26,sell,2568,0.01,1.81432,,,GBPAUD
5073,2009.11.19 16:31,buy,2569,0.01,0.97855,,,AUDCAD
5074,2009.11.19 16:31,buy,2570,0.01,0.93145,,,AUDCHF
5075,2009.11.19 16:31,buy,2571,0.01,81.2910,,,AUDJPY
5076,2009.11.19 16:31,buy,2572,0.01,1.25606,,,AUDNZD
5077,2009.11.19 16:31,buy,2573,0.01,0.91592,,,AUDUSD
5078,2009.11.19 16:31,sell,2574,0.01,1.62407,,,EURAUD
5079,2009.11.19 16:46,sell,2575,0.01,1.81641,,,GBPAUD
5080,2009.11.19 16:50,sell,2576,0.01,1.62547,,,EURAUD
5081,2009.11.19 16:51,buy,2577,0.01,0.97693,,,AUDCAD
5082,2009.11.19 16:51,buy,2578,0.01,0.93076,,,AUDCHF
5083,2009.11.19 16:51,buy,2579,0.01,81.1520,,,AUDJPY
5084,2009.11.19 16:51,buy,2580,0.01,1.25572,,,AUDNZD
5085,2009.11.19 16:51,buy,2581,0.01,0.91394,,,AUDUSD
5086,2009.11.23 09:25,close,2576,0.01,1.62314,2.60,19500.09,EURAUD
5087,2009.11.23 09:25,close,2574,0.01,1.62314,1.16,19501.25,EURAUD
5088,2009.11.23 09:25,close,2562,0.01,1.62314,-3.66,19497.59,EURAUD
5089,2009.11.23 09:25,close,2558,0.01,1.62314,-7.11,19490.48,EURAUD
5090,2009.11.23 09:25,close,2553,0.01,1.62314,-7.81,19482.67,EURAUD
5091,2009.11.23 09:25,close,2552,0.01,1.62314,-7.85,19474.82,EURAUD
5092,2009.11.23 09:25,close,2539,0.01,1.62314,-17.40,19457.42,EURAUD
5093,2009.11.23 09:25,close,2538,0.01,1.62314,-17.38,19440.04,EURAUD
5094,2009.11.23 09:25,close,2520,0.01,1.62314,-21.37,19418.67,EURAUD
5095,2009.11.23 09:25,close,2512,0.01,1.62314,-22.30,19396.37,EURAUD
5096,2009.11.23 09:25,close,2506,0.01,1.62314,-18.88,19377.49,EURAUD
5097,2009.11.23 09:27,close,2575,0.01,1.79706,20.14,19397.63,GBPAUD
5098,2009.11.23 09:27,close,2568,0.01,1.79706,17.99,19415.62,GBPAUD
5099,2009.11.23 09:27,close,2561,0.01,1.79706,16.17,19431.79,GBPAUD
5100,2009.11.23 09:27,close,2554,0.01,1.79706,17.67,19449.46,GBPAUD
5101,2009.11.23 09:27,close,2541,0.01,1.79706,17.74,19467.20,GBPAUD
5102,2009.11.23 09:27,close,2540,0.01,1.79706,17.72,19484.92,GBPAUD
5103,2009.11.23 09:27,close,2527,0.01,1.79706,13.59,19498.51,GBPAUD
5104,2009.11.23 09:27,close,2526,0.01,1.79706,13.60,19512.11,GBPAUD
5105,2009.11.23 09:27,close,2519,0.01,1.79706,5.17,19517.28,GBPAUD
5106,2009.11.23 09:27,close,2516,0.01,1.79706,2.25,19519.53,GBPAUD
5107,2009.11.23 09:27,close,2505,0.01,1.79706,-9.10,19510.43,GBPAUD
5108,2009.11.23 09:28,close,2578,0.01,0.93110,0.50,19510.93,AUDCHF
5109,2009.11.23 09:28,close,2570,0.01,0.93110,-0.24,19510.69,AUDCHF
5110,2009.11.23 09:28,close,2564,0.01,0.93110,-3.22,19507.47,AUDCHF
5111,2009.11.23 09:28,close,2556,0.01,0.93110,-5.84,19501.63,AUDCHF
5112,2009.11.23 09:28,close,2543,0.01,0.93110,-6.20,19495.43,AUDCHF
5113,2009.11.23 09:28,close,2542,0.01,0.93110,-6.21,19489.22,AUDCHF
5114,2009.11.23 09:28,close,2533,0.01,0.93110,-10.31,19478.91,AUDCHF
5115,2009.11.23 09:28,close,2529,0.01,0.93110,-10.32,19468.59,AUDCHF
5116,2009.11.23 09:28,close,2521,0.01,0.93110,-11.70,19456.89,AUDCHF
5117,2009.11.23 09:28,close,2513,0.01,0.93110,-12.08,19444.81,AUDCHF
5118,2009.11.23 09:28,close,2508,0.01,0.93110,-10.03,19434.78,AUDCHF
5119,2009.11.23 09:29,close,2577,0.01,0.97879,1.94,19436.72,AUDCAD
5120,2009.11.23 09:29,close,2569,0.01,0.97879,0.33,19437.05,AUDCAD
5121,2009.11.23 09:29,close,2563,0.01,0.97879,4.46,19441.51,AUDCAD
5122,2009.11.23 09:29,close,2555,0.01,0.97879,3.40,19444.91,AUDCAD
5123,2009.11.23 09:29,close,2548,0.01,0.97879,2.39,19447.30,AUDCAD
5124,2009.11.23 09:29,close,2547,0.01,0.97879,2.37,19449.67,AUDCAD
5125,2009.11.23 09:29,close,2532,0.01,0.97879,-1.86,19447.81,AUDCAD
5126,2009.11.23 09:29,close,2528,0.01,0.97879,-1.82,19445.99,AUDCAD
5127,2009.11.23 09:29,close,2522,0.01,0.97879,-0.07,19445.92,AUDCAD
5128,2009.11.23 09:29,close,2517,0.01,0.97879,-0.69,19445.23,AUDCAD
5129,2009.11.23 09:29,close,2507,0.01,0.97879,2.11,19447.34,AUDCAD
5130,2009.11.23 09:29,close,2579,0.01,82.0300,9.00,19456.34,AUDJPY
5131,2009.11.23 09:29,close,2571,0.01,82.0300,7.60,19463.94,AUDJPY
5132,2009.11.23 09:29,close,2565,0.01,82.0300,5.48,19469.42,AUDJPY
5133,2009.11.23 09:29,close,2557,0.01,82.0300,2.42,19471.84,AUDJPY
5134,2009.11.23 09:29,close,2545,0.01,82.0300,2.17,19474.01,AUDJPY
5135,2009.11.23 09:29,close,2544,0.01,82.0300,2.19,19476.20,AUDJPY
5136,2009.11.23 09:29,close,2534,0.01,82.0300,-6.44,19469.76,AUDJPY
5137,2009.11.23 09:29,close,2530,0.01,82.0300,-6.43,19463.33,AUDJPY
5138,2009.11.23 09:29,close,2523,0.01,82.0300,-10.18,19453.15,AUDJPY
5139,2009.11.23 09:29,close,2514,0.01,82.0300,-11.58,19441.57,AUDJPY
5140,2009.11.23 09:29,close,2509,0.01,82.0300,-14.74,19426.83,AUDJPY
5141,2009.11.23 09:29,close,2580,0.01,1.26223,5.55,19432.38,AUDNZD
5142,2009.11.23 09:29,close,2572,0.01,1.26223,5.26,19437.64,AUDNZD
5143,2009.11.23 09:29,close,2566,0.01,1.26223,4.59,19442.23,AUDNZD
5144,2009.11.23 09:29,close,2559,0.01,1.26223,5.71,19447.94,AUDNZD
5145,2009.11.23 09:29,close,2549,0.01,1.26223,5.49,19453.43,AUDNZD
5146,2009.11.23 09:29,close,2546,0.01,1.26223,5.48,19458.91,AUDNZD
5147,2009.11.23 09:29,close,2535,0.01,1.26223,13.56,19472.47,AUDNZD
5148,2009.11.23 09:29,close,2531,0.01,1.26223,13.57,19486.04,AUDNZD
5149,2009.11.23 09:29,close,2524,0.01,1.26223,11.19,19497.23,AUDNZD
5150,2009.11.23 09:29,close,2515,0.01,1.26223,11.61,19508.84,AUDNZD
5151,2009.11.23 09:29,close,2510,0.01,1.26223,5.85,19514.69,AUDNZD
5152,2009.11.23 09:30,close,2581,0.01,0.92296,9.15,19523.84,AUDUSD
5153,2009.11.23 09:30,close,2573,0.01,0.92296,7.17,19531.01,AUDUSD
5154,2009.11.23 09:30,close,2567,0.01,0.92296,5.35,19536.36,AUDUSD
5155,2009.11.23 09:30,close,2560,0.01,0.92296,3.18,19539.54,AUDUSD
5156,2009.11.23 09:30,close,2551,0.01,0.92296,2.88,19542.42,AUDUSD
5157,2009.11.23 09:30,close,2550,0.01,0.92296,2.89,19545.31,AUDUSD
5158,2009.11.23 09:30,close,2537,0.01,0.92296,-4.95,19540.36,AUDUSD
5159,2009.11.23 09:30,close,2536,0.01,0.92296,-4.94,19535.42,AUDUSD
5160,2009.11.23 09:30,close,2525,0.01,0.92296,-9.43,19525.99,AUDUSD
5161,2009.11.23 09:30,close,2518,0.01,0.92296,-10.80,19515.19,AUDUSD
5162,2009.11.23 09:30,close,2511,0.01,0.92296,-10.20,19504.99,AUDUSD
5163,2009.11.24 09:22,sell,2582,0.01,1.62595,,,EURAUD
5164,2009.11.24 09:23,sell,2583,0.01,1.80261,,,GBPAUD
5165,2009.11.24 09:26,buy,2584,0.01,0.97466,,,AUDCAD
5166,2009.11.24 09:26,buy,2585,0.01,0.92997,,,AUDCHF
5167,2009.11.24 09:26,buy,2586,0.01,81.3020,,,AUDJPY
5168,2009.11.24 09:26,buy,2587,0.01,1.26385,,,AUDNZD
5169,2009.11.24 09:27,buy,2588,0.01,0.91788,,,AUDUSD
5170,2009.11.24 17:55,sell,2589,0.01,1.80819,,,GBPAUD
5171,2009.11.24 17:58,buy,2590,0.01,0.92779,,,AUDCHF
5172,2009.11.24 17:59,buy,2591,0.01,0.97260,,,AUDCAD
5173,2009.11.24 17:59,buy,2592,0.01,81.2230,,,AUDJPY
5174,2009.11.24 17:59,buy,2593,0.01,1.26695,,,AUDNZD
5175,2009.11.24 17:59,sell,2594,0.01,1.62865,,,EURAUD
5176,2009.11.24 18:00,buy,2595,0.01,0.91687,,,AUDUSD
5177,2009.11.24 18:09,sell,2596,0.01,1.80892,,,GBPAUD
5178,2009.11.24 18:14,buy,2597,0.01,0.97156,,,AUDCAD
5179,2009.11.24 18:14,buy,2598,0.01,0.92647,,,AUDCHF
5180,2009.11.24 18:14,buy,2599,0.01,81.1570,,,AUDJPY
5181,2009.11.24 18:14,buy,2600,0.01,1.26621,,,AUDNZD
5182,2009.11.24 18:14,buy,2601,0.01,0.91653,,,AUDUSD
5183,2009.11.24 18:14,sell,2602,0.01,1.63073,,,EURAUD
5184,2009.11.25 06:55,close,2602,0.01,1.62108,10.04,19515.03,EURAUD
5185,2009.11.25 06:55,close,2594,0.01,1.62108,7.90,19522.93,EURAUD
5186,2009.11.25 06:55,close,2582,0.01,1.62108,5.12,19528.05,EURAUD
5187,2009.11.25 07:00,close,2597,0.01,0.97670,5.14,19533.19,AUDCAD
5188,2009.11.25 07:00,close,2591,0.01,0.97670,4.11,19537.30,AUDCAD
5189,2009.11.25 07:00,close,2584,0.01,0.97670,2.07,19539.37,AUDCAD
5190,2009.11.25 07:00,close,2598,0.01,0.93154,5.48,19544.85,AUDCHF
5191,2009.11.25 07:00,close,2590,0.01,0.93154,4.07,19548.92,AUDCHF
5192,2009.11.25 07:00,close,2585,0.01,0.93154,1.74,19550.66,AUDCHF
5193,2009.11.25 07:00,close,2599,0.01,81.6530,5.07,19555.73,AUDJPY
5194,2009.11.25 07:00,close,2592,0.01,81.6530,4.41,19560.14,AUDJPY
5195,2009.11.25 07:00,close,2586,0.01,81.6530,3.61,19563.75,AUDJPY
5196,2009.11.25 07:00,close,2600,0.01,1.26998,3.21,19566.96,AUDNZD
5197,2009.11.25 07:00,close,2593,0.01,1.26998,2.58,19569.54,AUDNZD
5198,2009.11.25 07:00,close,2587,0.01,1.26998,5.23,19574.77,AUDNZD
5199,2009.11.25 07:00,close,2601,0.01,0.92432,7.86,19582.63,AUDUSD
5200,2009.11.25 07:00,close,2595,0.01,0.92432,7.52,19590.15,AUDUSD
5201,2009.11.25 07:00,close,2588,0.01,0.92432,6.51,19596.66,AUDUSD
5202,2009.11.25 07:00,close,2596,0.01,1.79586,13.56,19610.22,GBPAUD
5203,2009.11.25 07:00,close,2589,0.01,1.79586,12.81,19623.03,GBPAUD
5204,2009.11.25 07:00,close,2583,0.01,1.79586,7.06,19630.09,GBPAUD
5205,2009.11.26 02:25,sell,2603,0.01,1.62759,,,EURAUD
5206,2009.11.26 02:25,sell,2604,0.01,1.79956,,,GBPAUD
5207,2009.11.26 02:27,buy,2605,0.01,81.1960,,,AUDJPY
5208,2009.11.26 02:29,buy,2606,0.01,0.97166,,,AUDCAD
5209,2009.11.26 02:29,buy,2607,0.01,0.92590,,,AUDCHF
5210,2009.11.26 02:29,buy,2608,0.01,1.27414,,,AUDNZD
5211,2009.11.26 02:30,buy,2609,0.01,0.92805,,,AUDUSD
5212,2009.11.26 07:55,buy,2610,0.01,0.92375,,,AUDCHF
5213,2009.11.26 07:55,buy,2611,0.01,0.92374,,,AUDCHF
5214,2009.11.26 07:55,sell,2612,0.01,1.63504,,,EURAUD
5215,2009.11.26 07:55,sell,2613,0.01,1.63502,,,EURAUD
5216,2009.11.26 07:57,buy,2614,0.01,80.1270,,,AUDJPY
5217,2009.11.26 07:57,buy,2615,0.01,80.1310,,,AUDJPY
5218,2009.11.26 07:58,sell,2616,0.01,1.80586,,,GBPAUD
5219,2009.11.26 07:58,sell,2617,0.01,1.80581,,,GBPAUD
5220,2009.11.26 07:59,buy,2618,0.01,0.96843,,,AUDCAD
5221,2009.11.26 07:59,buy,2619,0.01,0.96846,,,AUDCAD
5222,2009.11.26 08:00,buy,2620,0.01,1.27581,,,AUDNZD
5223,2009.11.26 08:00,buy,2621,0.01,1.27585,,,AUDNZD
5224,2009.11.26 08:00,buy,2622,0.01,0.92171,,,AUDUSD
5225,2009.11.26 08:00,buy,2623,0.01,0.92172,,,AUDUSD
5226,2009.11.26 12:07,buy,2624,0.01,0.91882,,,AUDCHF
5227,2009.11.26 12:08,sell,2625,0.01,1.64163,,,EURAUD
5228,2009.11.26 12:11,sell,2626,0.01,1.80275,,,GBPAUD
5229,2009.11.26 12:12,buy,2627,0.01,0.96781,,,AUDCAD
5230,2009.11.26 12:12,buy,2628,0.01,79.8150,,,AUDJPY
5231,2009.11.26 12:12,buy,2629,0.01,1.27540,,,AUDNZD
5232,2009.11.26 12:12,buy,2630,0.01,0.91951,,,AUDUSD
5233,2009.11.26 14:55,buy,2631,0.01,0.91974,,,AUDCHF
5234,2009.11.26 14:59,buy,2632,0.01,0.96625,,,AUDCAD
5235,2009.11.26 14:59,buy,2633,0.01,1.27574,,,AUDNZD
5236,2009.11.26 14:59,sell,2634,0.01,1.64260,,,EURAUD
5237,2009.11.26 14:59,sell,2635,0.01,1.80441,,,GBPAUD
5238,2009.11.26 15:00,buy,2636,0.01,79.4450,,,AUDJPY
5239,2009.11.26 15:00,buy,2637,0.01,0.91714,,,AUDUSD
5240,2009.11.26 18:25,buy,2638,0.01,0.91555,,,AUDCHF
5241,2009.11.26 18:27,sell,2639,0.01,1.64416,,,EURAUD
5242,2009.11.26 18:28,buy,2640,0.01,79.0070,,,AUDJPY
5243,2009.11.26 18:28,buy,2641,0.01,1.27539,,,AUDNZD
5244,2009.11.26 18:28,sell,2642,0.01,1.80701,,,GBPAUD
5245,2009.11.26 18:29,buy,2643,0.01,0.96814,,,AUDCAD
5246,2009.11.26 18:30,buy,2644,0.01,0.91295,,,AUDUSD
5247,2009.11.26 18:44,buy,2645,0.01,0.91582,,,AUDCHF
5248,2009.11.26 18:45,sell,2646,0.01,1.64379,,,EURAUD
5249,2009.11.26 18:47,buy,2647,0.01,78.9170,,,AUDJPY
5250,2009.11.26 18:47,buy,2648,0.01,1.27548,,,AUDNZD
5251,2009.11.26 18:48,sell,2649,0.01,1.80737,,,GBPAUD
5252,2009.11.26 18:49,buy,2650,0.01,0.96852,,,AUDCAD
5253,2009.11.26 18:49,buy,2651,0.01,0.91265,,,AUDUSD
5254,2009.11.27 05:55,sell,2652,0.01,1.65055,,,EURAUD
5255,2009.11.27 05:55,sell,2653,0.01,1.65049,,,EURAUD
5256,2009.11.27 05:55,sell,2654,0.01,1.65044,,,EURAUD
5257,2009.11.27 05:56,sell,2655,0.01,1.65119,,,EURAUD
5258,2009.11.27 05:59,buy,2656,0.01,0.96213,,,AUDCAD
5259,2009.11.27 05:59,buy,2657,0.01,0.96214,,,AUDCAD
5260,2009.11.27 05:59,buy,2658,0.01,0.96215,,,AUDCAD
5261,2009.11.27 05:59,buy,2659,0.01,0.91255,,,AUDCHF
5262,2009.11.27 05:59,buy,2660,0.01,0.91256,,,AUDCHF
5263,2009.11.27 05:59,buy,2661,0.01,0.91257,,,AUDCHF
5264,2009.11.27 05:59,buy,2662,0.01,78.0980,,,AUDJPY
5265,2009.11.27 05:59,buy,2663,0.01,78.0940,,,AUDJPY
5266,2009.11.27 05:59,buy,2664,0.01,78.0900,,,AUDJPY
5267,2009.11.27 05:59,buy,2665,0.01,1.27097,,,AUDNZD
5268,2009.11.27 05:59,buy,2666,0.01,1.27094,,,AUDNZD
5269,2009.11.27 05:59,buy,2667,0.01,1.27092,,,AUDNZD
5270,2009.11.27 05:59,sell,2668,0.01,1.81279,,,GBPAUD
5271,2009.11.27 05:59,sell,2669,0.01,1.81282,,,GBPAUD
5272,2009.11.27 05:59,sell,2670,0.01,1.81284,,,GBPAUD
5273,2009.11.27 06:00,buy,2671,0.02,0.90426,,,AUDUSD
5274,2009.11.27 06:00,buy,2672,0.01,0.90422,,,AUDUSD
5275,2009.11.27 06:00,sell,2673,0.01,1.81322,,,GBPAUD
5276,2009.11.27 06:01,buy,2674,0.01,0.96133,,,AUDCAD
5277,2009.11.27 06:01,buy,2675,0.01,0.91206,,,AUDCHF
5278,2009.11.27 06:01,buy,2676,0.01,78.0820,,,AUDJPY
5279,2009.11.27 06:01,buy,2677,0.01,1.27047,,,AUDNZD
5280,2009.11.27 06:01,buy,2678,0.01,0.90377,,,AUDUSD
5281,2009.11.27 06:22,sell,2679,0.01,1.65279,,,EURAUD
5282,2009.11.27 06:24,sell,2680,0.01,1.81756,,,GBPAUD
5283,2009.11.27 06:27,buy,2681,0.01,0.96050,,,AUDCAD
5284,2009.11.27 06:27,buy,2682,0.01,0.91201,,,AUDCHF
5285,2009.11.27 06:27,buy,2683,0.01,77.9130,,,AUDJPY
5286,2009.11.27 06:27,buy,2684,0.01,1.27021,,,AUDNZD
5287,2009.11.27 06:27,buy,2685,0.01,0.90300,,,AUDUSD
5288,2009.11.27 09:30,sell,2686,0.01,1.65689,,,EURAUD
5289,2009.11.27 09:34,buy,2687,0.01,1.27308,,,AUDNZD
5290,2009.11.27 09:34,sell,2688,0.01,1.81972,,,GBPAUD
5291,2009.11.27 09:35,buy,2689,0.01,0.96295,,,AUDCAD
5292,2009.11.27 09:35,buy,2690,0.01,0.91146,,,AUDCHF
5293,2009.11.27 09:35,buy,2691,0.01,77.5710,,,AUDJPY
5294,2009.11.27 09:35,buy,2692,0.01,0.89865,,,AUDUSD
5295,2009.11.30 05:55,close,2686,0.01,1.64082,16.66,19646.75,EURAUD
5296,2009.11.30 05:55,close,2679,0.01,1.64082,12.43,19659.18,EURAUD
5297,2009.11.30 05:55,close,2655,0.01,1.64082,10.79,19669.97,EURAUD
5298,2009.11.30 05:55,close,2654,0.01,1.64082,10.01,19679.98,EURAUD
5299,2009.11.30 05:55,close,2653,0.01,1.64082,10.06,19690.04,EURAUD
5300,2009.11.30 05:55,close,2652,0.01,1.64082,10.13,19700.17,EURAUD
5301,2009.11.30 05:55,close,2646,0.01,1.64082,3.26,19703.43,EURAUD
5302,2009.11.30 05:55,close,2639,0.01,1.64082,3.64,19707.07,EURAUD
5303,2009.11.30 05:55,close,2634,0.01,1.64082,2.04,19709.11,EURAUD
5304,2009.11.30 05:55,close,2625,0.01,1.64082,1.04,19710.15,EURAUD
5305,2009.11.30 05:55,close,2613,0.01,1.64082,-5.78,19704.37,EURAUD
5306,2009.11.30 05:55,close,2612,0.01,1.64082,-5.75,19698.62,EURAUD
5307,2009.11.30 05:55,close,2603,0.01,1.64082,-13.43,19685.19,EURAUD
5308,2009.11.30 05:56,close,2691,0.01,79.2860,17.37,19702.56,AUDJPY
5309,2009.11.30 05:56,close,2683,0.01,79.2860,13.92,19716.48,AUDJPY
5310,2009.11.30 05:56,close,2676,0.01,79.2860,12.22,19728.70,AUDJPY
5311,2009.11.30 05:56,close,2664,0.01,79.2860,12.14,19740.84,AUDJPY
5312,2009.11.30 05:56,close,2663,0.01,79.2860,12.10,19752.94,AUDJPY
5313,2009.11.30 05:56,close,2662,0.01,79.2860,12.06,19765.00,AUDJPY
5314,2009.11.30 05:56,close,2647,0.01,79.2860,3.87,19768.87,AUDJPY
5315,2009.11.30 05:56,close,2640,0.01,79.2860,2.97,19771.84,AUDJPY
5316,2009.11.30 05:56,close,2636,0.01,79.2860,-1.45,19770.39,AUDJPY
5317,2009.11.30 05:56,close,2628,0.01,79.2860,-5.18,19765.21,AUDJPY
5318,2009.11.30 05:56,close,2615,0.01,79.2860,-8.37,19756.84,AUDJPY
5319,2009.11.30 05:56,close,2614,0.01,79.2860,-8.33,19748.51,AUDJPY
5320,2009.11.30 05:56,close,2605,0.01,79.2860,-19.11,19729.40,AUDJPY
5321,2009.11.30 05:58,close,2688,0.01,1.80425,16.04,19745.44,GBPAUD
5322,2009.11.30 05:58,close,2680,0.01,1.80425,13.81,19759.25,GBPAUD
5323,2009.11.30 05:58,close,2673,0.01,1.80425,9.34,19768.59,GBPAUD
5324,2009.11.30 05:58,close,2670,0.01,1.80425,8.95,19777.54,GBPAUD
5325,2009.11.30 05:58,close,2669,0.01,1.80425,8.93,19786.47,GBPAUD
5326,2009.11.30 05:58,close,2668,0.01,1.80425,8.90,19795.37,GBPAUD
5327,2009.11.30 05:58,close,2649,0.01,1.80425,3.41,19798.78,GBPAUD
5328,2009.11.30 05:58,close,2642,0.01,1.80425,3.04,19801.82,GBPAUD
5329,2009.11.30 05:58,close,2635,0.01,1.80425,0.36,19802.18,GBPAUD
5330,2009.11.30 05:58,close,2626,0.01,1.80425,-1.35,19800.83,GBPAUD
5331,2009.11.30 05:58,close,2617,0.01,1.80425,1.81,19802.64,GBPAUD
5332,2009.11.30 05:58,close,2616,0.01,1.80425,1.86,19804.50,GBPAUD
5333,2009.11.30 05:58,close,2604,0.01,1.80425,-4.63,19799.87,GBPAUD
5334,2009.11.30 05:59,close,2689,0.01,0.96909,6.13,19806.00,AUDCAD
5335,2009.11.30 05:59,close,2681,0.01,0.96909,8.56,19814.56,AUDCAD
5336,2009.11.30 05:59,close,2674,0.01,0.96909,7.74,19822.30,AUDCAD
5337,2009.11.30 05:59,close,2658,0.01,0.96909,6.93,19829.23,AUDCAD
5338,2009.11.30 05:59,close,2657,0.01,0.96909,6.94,19836.17,AUDCAD
5339,2009.11.30 05:59,close,2656,0.01,0.96909,6.95,19843.12,AUDCAD
5340,2009.11.30 05:59,close,2650,0.01,0.96909,0.66,19843.78,AUDCAD
5341,2009.11.30 05:59,close,2643,0.01,0.96909,1.04,19844.82,AUDCAD
5342,2009.11.30 05:59,close,2632,0.01,0.96909,2.91,19847.73,AUDCAD
5343,2009.11.30 05:59,close,2627,0.01,0.96909,1.36,19849.09,AUDCAD
5344,2009.11.30 05:59,close,2619,0.01,0.96909,0.72,19849.81,AUDCAD
5345,2009.11.30 05:59,close,2618,0.01,0.96909,0.75,19850.56,AUDCAD
5346,2009.11.30 05:59,close,2606,0.01,0.96909,-2.46,19848.10,AUDCAD
5347,2009.11.30 05:59,close,2690,0.01,0.91874,7.85,19855.95,AUDCHF
5348,2009.11.30 05:59,close,2682,0.01,0.91874,7.26,19863.21,AUDCHF
5349,2009.11.30 05:59,close,2675,0.01,0.91874,7.21,19870.42,AUDCHF
5350,2009.11.30 05:59,close,2661,0.01,0.91874,6.66,19877.08,AUDCHF
5351,2009.11.30 05:59,close,2660,0.01,0.91874,6.67,19883.75,AUDCHF
5352,2009.11.30 05:59,close,2659,0.01,0.91874,6.68,19890.43,AUDCHF
5353,2009.11.30 05:59,close,2645,0.01,0.91874,3.26,19893.69,AUDCHF
5354,2009.11.30 05:59,close,2638,0.01,0.91874,3.54,19897.23,AUDCHF
5355,2009.11.30 05:59,close,2631,0.01,0.91874,-0.93,19896.30,AUDCHF
5356,2009.11.30 05:59,close,2624,0.01,0.91874,0.05,19896.35,AUDCHF
5357,2009.11.30 05:59,close,2611,0.01,0.91874,-5.21,19891.14,AUDCHF
5358,2009.11.30 05:59,close,2610,0.01,0.91874,-5.22,19885.92,AUDCHF
5359,2009.11.30 05:59,close,2607,0.01,0.91874,-7.52,19878.40,AUDCHF
5360,2009.11.30 05:59,close,2687,0.01,1.27272,-0.31,19878.09,AUDNZD
5361,2009.11.30 05:59,close,2684,0.01,1.27272,2.14,19880.23,AUDNZD
5362,2009.11.30 05:59,close,2677,0.01,1.27272,1.92,19882.15,AUDNZD
5363,2009.11.30 05:59,close,2667,0.01,1.27272,1.53,19883.68,AUDNZD
5364,2009.11.30 05:59,close,2666,0.01,1.27272,1.52,19885.20,AUDNZD
5365,2009.11.30 05:59,close,2665,0.01,1.27272,1.49,19886.69,AUDNZD
5366,2009.11.30 05:59,close,2648,0.01,1.27272,-2.37,19884.32,AUDNZD
5367,2009.11.30 05:59,close,2641,0.01,1.27272,-2.29,19882.03,AUDNZD
5368,2009.11.30 05:59,close,2633,0.01,1.27272,-2.59,19879.44,AUDNZD
5369,2009.11.30 05:59,close,2629,0.01,1.27272,-2.30,19877.14,AUDNZD
5370,2009.11.30 05:59,close,2621,0.01,1.27272,-2.68,19874.46,AUDNZD
5371,2009.11.30 05:59,close,2620,0.01,1.27272,-2.65,19871.81,AUDNZD
5372,2009.11.30 05:59,close,2608,0.01,1.27272,-1.22,19870.59,AUDNZD
5373,2009.11.30 06:00,close,2692,0.01,0.91746,18.88,19889.47,AUDUSD
5374,2009.11.30 06:00,close,2685,0.01,0.91746,14.53,19904.00,AUDUSD
5375,2009.11.30 06:00,close,2678,0.01,0.91746,13.75,19917.75,AUDUSD
5376,2009.11.30 06:00,close,2672,0.01,0.91746,13.31,19931.06,AUDUSD
5377,2009.11.30 06:00,close,2671,0.02,0.91746,26.53,19957.59,AUDUSD
5378,2009.11.30 06:00,close,2651,0.01,0.91746,4.94,19962.53,AUDUSD
5379,2009.11.30 06:00,close,2644,0.01,0.91746,4.64,19967.17,AUDUSD
5380,2009.11.30 06:00,close,2637,0.01,0.91746,0.45,19967.62,AUDUSD
5381,2009.11.30 06:00,close,2630,0.01,0.91746,-1.92,19965.70,AUDUSD
5382,2009.11.30 06:00,close,2623,0.01,0.91746,-4.13,19961.57,AUDUSD
5383,2009.11.30 06:00,close,2622,0.01,0.91746,-4.12,19957.45,AUDUSD
5384,2009.11.30 06:00,close,2609,0.01,0.91746,-10.46,19946.99,AUDUSD
5385,2009.12.04 02:25,sell,2693,0.01,1.63021,,,EURAUD
5386,2009.12.04 02:29,buy,2694,0.01,0.97561,,,AUDCAD
5387,2009.12.04 02:29,buy,2695,0.01,0.92348,,,AUDCHF
5388,2009.12.04 02:29,buy,2696,0.01,81.4200,,,AUDJPY
5389,2009.12.04 02:29,buy,2697,0.01,1.27772,,,AUDNZD
5390,2009.12.04 02:29,sell,2698,0.01,1.79136,,,GBPAUD
5391,2009.12.04 02:30,buy,2699,0.01,0.92314,,,AUDUSD
5392,2009.12.04 17:25,sell,2700,0.01,1.62326,,,EURAUD
5393,2009.12.04 17:26,sell,2701,0.01,1.80369,,,GBPAUD
5394,2009.12.04 17:29,buy,2702,0.01,0.96275,,,AUDCAD
5395,2009.12.04 17:29,buy,2703,0.01,0.92877,,,AUDCHF
5396,2009.12.04 17:29,buy,2704,0.01,82.3690,,,AUDJPY
5397,2009.12.04 17:29,buy,2705,0.01,1.27684,,,AUDNZD
5398,2009.12.04 17:30,buy,2706,0.01,0.91527,,,AUDUSD
5399,2009.12.04 17:34,sell,2707,0.01,1.62514,,,EURAUD
5400,2009.12.04 17:34,sell,2708,0.01,1.80452,,,GBPAUD
5401,2009.12.04 17:38,buy,2709,0.01,0.92716,,,AUDCHF
5402,2009.12.04 17:38,buy,2710,0.01,82.2540,,,AUDJPY
5403,2009.12.04 17:39,buy,2711,0.01,0.96240,,,AUDCAD
5404,2009.12.04 17:39,buy,2712,0.01,1.27615,,,AUDNZD
5405,2009.12.04 17:39,buy,2713,0.01,0.91397,,,AUDUSD
5406,2009.12.04 17:40,sell,2714,0.01,1.62777,,,EURAUD
5407,2009.12.04 17:41,sell,2715,0.01,1.80676,,,GBPAUD
5408,2009.12.04 17:45,buy,2716,0.01,0.96237,,,AUDCAD
5409,2009.12.04 17:45,buy,2717,0.01,0.92632,,,AUDCHF
5410,2009.12.04 17:45,buy,2718,0.01,82.1040,,,AUDJPY
5411,2009.12.04 17:45,buy,2719,0.01,1.27559,,,AUDNZD
5412,2009.12.04 17:45,buy,2720,0.01,0.91311,,,AUDUSD
5413,2009.12.09 20:55,sell,2721,0.01,1.79019,,,GBPAUD
5414,2009.12.09 20:59,buy,2722,0.01,0.93076,,,AUDCHF
5415,2009.12.09 20:59,buy,2723,0.01,79.5230,,,AUDJPY
5416,2009.12.09 20:59,buy,2724,0.01,1.27140,,,AUDNZD
5417,2009.12.09 21:00,buy,2725,0.01,0.95521,,,AUDCAD
5418,2009.12.09 21:00,buy,2726,0.01,0.90638,,,AUDUSD
5419,2009.12.09 21:00,sell,2727,0.01,1.62299,,,EURAUD
5420,2009.12.10 05:01,close,2727,0.01,1.61048,13.18,19960.17,EURAUD
5421,2009.12.10 05:01,close,2714,0.01,1.61048,18.40,19978.57,EURAUD
5422,2009.12.10 05:01,close,2707,0.01,1.61048,15.69,19994.26,EURAUD
5423,2009.12.10 05:01,close,2700,0.01,1.61048,13.76,20008.02,EURAUD
5424,2009.12.10 05:01,close,2693,0.01,1.61048,20.92,20028.94,EURAUD
5425,2009.12.10 05:03,close,2723,0.01,80.5440,10.52,20039.46,AUDJPY
5426,2009.12.10 05:03,close,2718,0.01,80.5440,-15.29,20024.17,AUDJPY
5427,2009.12.10 05:03,close,2710,0.01,80.5440,-16.80,20007.37,AUDJPY
5428,2009.12.10 05:03,close,2704,0.01,80.5440,-17.96,19989.41,AUDJPY
5429,2009.12.10 05:03,close,2696,0.01,80.5440,-8.39,19981.02,AUDJPY
5430,2009.12.10 05:03,close,2721,0.01,1.77954,11.27,19992.29,GBPAUD
5431,2009.12.10 05:03,close,2715,0.01,1.77954,28.64,20020.93,GBPAUD
5432,2009.12.10 05:03,close,2708,0.01,1.77954,26.33,20047.26,GBPAUD
5433,2009.12.10 05:03,close,2701,0.01,1.77954,25.47,20072.73,GBPAUD
5434,2009.12.10 05:03,close,2698,0.01,1.77954,12.77,20085.50,GBPAUD
5435,2009.12.10 05:04,close,2725,0.01,0.96504,9.88,20095.38,AUDCAD
5436,2009.12.10 05:04,close,2716,0.01,0.96504,2.91,20098.29,AUDCAD
5437,2009.12.10 05:04,close,2711,0.01,0.96504,2.88,20101.17,AUDCAD
5438,2009.12.10 05:04,close,2702,0.01,0.96504,2.53,20103.70,AUDCAD
5439,2009.12.10 05:04,close,2694,0.01,0.96504,-10.22,20093.48,AUDCAD
5440,2009.12.10 05:04,close,2724,0.01,1.26226,-7.82,20085.66,AUDNZD
5441,2009.12.10 05:04,close,2719,0.01,1.26226,-11.40,20074.26,AUDNZD
5442,2009.12.10 05:04,close,2712,0.01,1.26226,-11.88,20062.38,AUDNZD
5443,2009.12.10 05:04,close,2705,0.01,1.26226,-12.47,20049.91,AUDNZD
5444,2009.12.10 05:04,close,2697,0.01,1.26226,-13.22,20036.69,AUDNZD
5445,2009.12.10 05:05,close,2722,0.01,0.93853,8.50,20045.19,AUDCHF
5446,2009.12.10 05:05,close,2717,0.01,0.93853,13.44,20058.63,AUDCHF
5447,2009.12.10 05:05,close,2709,0.01,0.93853,12.54,20071.17,AUDCHF
5448,2009.12.10 05:05,close,2703,0.01,0.93853,10.82,20081.99,AUDCHF
5449,2009.12.10 05:05,close,2695,0.01,0.93853,16.48,20098.47,AUDCHF
5450,2009.12.10 05:06,close,2726,0.01,0.91407,7.89,20106.36,AUDUSD
5451,2009.12.10 05:06,close,2720,0.01,0.91407,1.35,20107.71,AUDUSD
5452,2009.12.10 05:06,close,2713,0.01,0.91407,0.49,20108.20,AUDUSD
5453,2009.12.10 05:06,close,2706,0.01,0.91407,-0.81,20107.39,AUDUSD
5454,2009.12.10 05:06,close,2699,0.01,0.91407,-8.68,20098.71,AUDUSD
5455,2009.12.14 05:25,buy,2728,0.01,80.7300,,,AUDJPY
5456,2009.12.14 05:25,sell,2729,0.01,1.61126,,,EURAUD
5457,2009.12.14 05:26,buy,2730,0.01,0.96371,,,AUDCAD
5458,2009.12.14 05:26,sell,2731,0.01,1.78597,,,GBPAUD
5459,2009.12.14 05:27,buy,2732,0.01,0.93835,,,AUDCHF
5460,2009.12.14 05:27,buy,2733,0.01,1.25444,,,AUDNZD
5461,2009.12.14 05:30,buy,2734,0.01,0.90991,,,AUDUSD
5462,2009.12.14 23:25,close,2732,0.01,0.94512,7.23,20105.94,AUDCHF
5463,2009.12.14 23:27,close,2728,0.01,81.2120,4.86,20110.80,AUDJPY
5464,2009.12.14 23:27,close,2729,0.01,1.59878,12.86,20123.66,EURAUD
5465,2009.12.14 23:27,close,2731,0.01,1.77952,6.64,20130.30,GBPAUD
5466,2009.12.14 23:28,close,2730,0.01,0.97024,6.48,20136.78,AUDCAD
5467,2009.12.14 23:28,close,2733,0.01,1.25828,3.28,20140.06,AUDNZD
5468,2009.12.14 23:30,close,2734,0.01,0.91557,5.66,20145.72,AUDUSD
5469,2009.12.15 09:55,sell,2735,0.01,1.60203,,,EURAUD
5470,2009.12.15 09:58,sell,2736,0.01,1.79112,,,GBPAUD
5471,2009.12.15 09:59,buy,2737,0.01,0.96537,,,AUDCAD
5472,2009.12.15 10:00,buy,2738,0.01,0.94404,,,AUDCHF
5473,2009.12.15 10:00,buy,2739,0.01,80.9740,,,AUDJPY
5474,2009.12.15 10:00,buy,2740,0.01,1.25796,,,AUDNZD
5475,2009.12.15 10:00,buy,2741,0.01,0.90889,,,AUDUSD
5476,2009.12.16 11:55,sell,2742,0.01,1.81555,,,GBPAUD
5477,2009.12.16 11:55,sell,2743,0.01,1.81557,,,GBPAUD
5478,2009.12.16 11:55,sell,2744,0.01,1.81559,,,GBPAUD
5479,2009.12.16 11:58,sell,2745,0.01,1.61793,,,EURAUD
5480,2009.12.16 11:58,sell,2746,0.01,1.61790,,,EURAUD
5481,2009.12.16 11:58,sell,2747,0.01,1.61788,,,EURAUD
5482,2009.12.16 12:00,buy,2748,0.01,0.95532,,,AUDCAD
5483,2009.12.16 12:00,buy,2749,0.01,0.95531,,,AUDCAD
5484,2009.12.16 12:00,buy,2750,0.01,0.95530,,,AUDCAD
5485,2009.12.16 12:00,buy,2751,0.01,0.93492,,,AUDCHF
5486,2009.12.16 12:00,buy,2752,0.01,0.93491,,,AUDCHF
5487,2009.12.16 12:00,buy,2753,0.01,0.93489,,,AUDCHF
5488,2009.12.16 12:00,buy,2754,0.01,80.6720,,,AUDJPY
5489,2009.12.16 12:00,buy,2755,0.01,80.6610,,,AUDJPY
5490,2009.12.16 12:00,buy,2756,0.01,80.6490,,,AUDJPY
5491,2009.12.16 12:00,buy,2757,0.01,1.25180,,,AUDNZD
5492,2009.12.16 12:00,buy,2758,0.01,1.25176,,,AUDNZD
5493,2009.12.16 12:00,buy,2759,0.01,1.25178,,,AUDNZD
5494,2009.12.16 12:00,buy,2760,0.02,0.89943,,,AUDUSD
5495,2009.12.16 12:00,buy,2761,0.01,0.89942,,,AUDUSD
5496,2009.12.16 17:56,sell,2762,0.01,1.81607,,,GBPAUD
5497,2009.12.16 17:59,buy,2763,0.01,0.95375,,,AUDCAD
5498,2009.12.16 17:59,buy,2764,0.01,0.93362,,,AUDCHF
5499,2009.12.16 17:59,sell,2765,0.01,1.61676,,,EURAUD
5500,2009.12.16 18:00,buy,2766,0.01,80.6830,,,AUDJPY
5501,2009.12.16 18:01,buy,2767,0.01,1.24800,,,AUDNZD
5502,2009.12.16 18:01,buy,2768,0.01,0.90131,,,AUDUSD
5503,2009.12.17 08:45,sell,2769,0.01,1.61769,,,EURAUD
5504,2009.12.17 08:45,sell,2770,0.01,1.61768,,,EURAUD
5505,2009.12.17 08:48,sell,2771,0.01,1.82256,,,GBPAUD
5506,2009.12.17 08:48,sell,2772,0.01,1.82257,,,GBPAUD
5507,2009.12.17 08:50,buy,2773,0.01,0.95026,,,AUDCAD
5508,2009.12.17 08:50,buy,2774,0.01,0.95025,,,AUDCAD
5509,2009.12.17 08:50,buy,2775,0.01,0.93204,,,AUDCHF
5510,2009.12.17 08:50,buy,2776,0.01,0.93203,,,AUDCHF
5511,2009.12.17 08:50,buy,2777,0.01,79.8520,,,AUDJPY
5512,2009.12.17 08:50,buy,2778,0.01,79.8500,,,AUDJPY
5513,2009.12.17 08:50,buy,2779,0.01,1.25078,,,AUDNZD
5514,2009.12.17 08:50,buy,2780,0.01,1.25079,,,AUDNZD
5515,2009.12.17 08:50,buy,2781,0.01,0.89098,,,AUDUSD
5516,2009.12.17 08:50,buy,2782,0.01,0.89105,,,AUDUSD
5517,2009.12.17 13:54,sell,2783,0.01,1.81673,,,GBPAUD
5518,2009.12.17 13:58,buy,2784,0.01,0.93034,,,AUDCHF
5519,2009.12.17 13:58,sell,2785,0.01,1.61841,,,EURAUD
5520,2009.12.17 13:59,buy,2786,0.01,0.95085,,,AUDCAD
5521,2009.12.17 13:59,buy,2787,0.01,79.7450,,,AUDJPY
5522,2009.12.17 13:59,buy,2788,0.01,1.24655,,,AUDNZD
5523,2009.12.17 13:59,buy,2789,0.01,0.88676,,,AUDUSD
5524,2009.12.18 01:55,buy,2790,0.01,79.0970,,,AUDJPY
5525,2009.12.18 01:55,buy,2791,0.01,79.0960,,,AUDJPY
5526,2009.12.18 01:55,sell,2792,0.01,1.61854,,,EURAUD
5527,2009.12.18 01:55,sell,2793,0.01,1.61852,,,EURAUD
5528,2009.12.18 01:58,buy,2794,0.01,0.92395,,,AUDCHF
5529,2009.12.18 01:58,buy,2795,0.01,0.92394,,,AUDCHF
5530,2009.12.18 01:59,buy,2796,0.01,0.94804,,,AUDCAD
5531,2009.12.18 01:59,sell,2797,0.01,1.82300,,,GBPAUD
5532,2009.12.18 02:00,buy,2798,0.01,0.94803,,,AUDCAD
5533,2009.12.18 02:00,buy,2799,0.01,1.24822,,,AUDNZD
5534,2009.12.18 02:00,buy,2800,0.01,1.24815,,,AUDNZD
5535,2009.12.18 02:00,buy,2801,0.01,0.88654,,,AUDUSD
5536,2009.12.18 02:00,buy,2802,0.01,0.88658,,,AUDUSD
5537,2009.12.18 02:00,sell,2803,0.01,1.82301,,,GBPAUD
5538,2009.12.22 03:55,buy,2804,0.01,80.2420,,,AUDJPY
5539,2009.12.22 03:55,buy,2805,0.01,80.2410,,,AUDJPY
5540,2009.12.22 03:55,sell,2806,0.01,1.82658,,,GBPAUD
5541,2009.12.22 03:56,sell,2807,0.01,1.62609,,,EURAUD
5542,2009.12.22 03:56,sell,2808,0.01,1.62610,,,EURAUD
5543,2009.12.22 03:56,sell,2809,0.01,1.82660,,,GBPAUD
5544,2009.12.22 03:57,buy,2810,0.01,0.93370,,,AUDCAD
5545,2009.12.22 03:57,buy,2811,0.01,0.93369,,,AUDCAD
5546,2009.12.22 03:57,buy,2812,0.01,0.91838,,,AUDCHF
5547,2009.12.22 03:57,buy,2813,0.01,0.91839,,,AUDCHF
5548,2009.12.22 03:57,buy,2814,0.01,1.24749,,,AUDNZD
5549,2009.12.22 03:57,buy,2815,0.01,1.24747,,,AUDNZD
5550,2009.12.22 04:00,buy,2816,0.01,0.87893,,,AUDUSD
5551,2009.12.22 04:00,buy,2817,0.01,0.87891,,,AUDUSD
5552,2009.12.23 11:25,sell,2818,0.01,1.82109,,,GBPAUD
5553,2009.12.23 11:26,buy,2819,0.01,0.91720,,,AUDCHF
5554,2009.12.23 11:29,buy,2820,0.01,0.92390,,,AUDCAD
5555,2009.12.23 11:29,buy,2821,0.01,80.3680,,,AUDJPY
5556,2009.12.23 11:29,sell,2822,0.01,1.62825,,,EURAUD
5557,2009.12.23 11:30,buy,2823,0.01,1.25010,,,AUDNZD
5558,2009.12.23 11:30,buy,2824,0.01,0.87519,,,AUDUSD
5559,2009.12.23 11:52,sell,2825,0.01,1.82216,,,GBPAUD
5560,2009.12.23 11:56,buy,2826,0.01,0.91535,,,AUDCHF
5561,2009.12.23 11:57,buy,2827,0.01,0.92301,,,AUDCAD
5562,2009.12.23 11:57,buy,2828,0.01,80.3010,,,AUDJPY
5563,2009.12.23 11:57,buy,2829,0.01,1.24997,,,AUDNZD
5564,2009.12.23 11:57,buy,2830,0.01,0.87466,,,AUDUSD
5565,2009.12.23 11:57,sell,2831,0.01,1.62964,,,EURAUD
5566,2009.12.28 11:27,close,2831,0.01,1.62058,9.82,20155.54,EURAUD
5567,2009.12.28 11:27,close,2822,0.01,1.62058,8.39,20163.93,EURAUD
5568,2009.12.28 11:27,close,2808,0.01,1.62058,6.27,20170.20,EURAUD
5569,2009.12.28 11:27,close,2807,0.01,1.62058,6.26,20176.46,EURAUD
5570,2009.12.28 11:27,close,2793,0.01,1.62058,-1.35,20175.11,EURAUD
5571,2009.12.28 11:27,close,2792,0.01,1.62058,-1.33,20173.78,EURAUD
5572,2009.12.28 11:27,close,2785,0.01,1.62058,-1.36,20172.42,EURAUD
5573,2009.12.28 11:27,close,2770,0.01,1.62058,-2.11,20170.31,EURAUD
5574,2009.12.28 11:27,close,2769,0.01,1.62058,-2.10,20168.21,EURAUD
5575,2009.12.28 11:27,close,2765,0.01,1.62058,-2.77,20165.44,EURAUD
5576,2009.12.28 11:27,close,2747,0.01,1.62058,-1.62,20163.82,EURAUD
5577,2009.12.28 11:27,close,2746,0.01,1.62058,-1.60,20162.22,EURAUD
5578,2009.12.28 11:27,close,2745,0.01,1.62058,-1.56,20160.66,EURAUD
5579,2009.12.28 11:27,close,2735,0.01,1.62058,-17.85,20142.81,EURAUD
5580,2009.12.28 11:32,close,2827,0.01,0.93082,7.96,20150.77,AUDCAD
5581,2009.12.28 11:32,close,2820,0.01,0.93082,7.08,20157.85,AUDCAD
5582,2009.12.28 11:32,close,2811,0.01,0.93082,-2.58,20155.27,AUDCAD
5583,2009.12.28 11:32,close,2810,0.01,0.93082,-2.59,20152.68,AUDCAD
5584,2009.12.28 11:32,close,2798,0.01,0.93082,-16.73,20135.95,AUDCAD
5585,2009.12.28 11:32,close,2796,0.01,0.93082,-16.74,20119.21,AUDCAD
5586,2009.12.28 11:32,close,2786,0.01,0.93082,-19.48,20099.73,AUDCAD
5587,2009.12.28 11:32,close,2774,0.01,0.93082,-18.89,20080.84,AUDCAD
5588,2009.12.28 11:32,close,2773,0.01,0.93082,-18.90,20061.94,AUDCAD
5589,2009.12.28 11:32,close,2763,0.01,0.93082,-22.23,20039.71,AUDCAD
5590,2009.12.28 11:32,close,2750,0.01,0.93082,-23.77,20015.94,AUDCAD
5591,2009.12.28 11:32,close,2749,0.01,0.93082,-23.78,19992.16,AUDCAD
5592,2009.12.28 11:32,close,2748,0.01,0.93082,-23.79,19968.37,AUDCAD
5593,2009.12.28 11:32,close,2737,0.01,0.93082,-33.72,19934.65,AUDCAD
5594,2009.12.28 11:32,close,2826,0.01,0.91892,4.14,19938.79,AUDCHF
5595,2009.12.28 11:32,close,2819,0.01,0.91892,2.16,19940.95,AUDCHF
5596,2009.12.28 11:32,close,2813,0.01,0.91892,0.96,19941.91,AUDCHF
5597,2009.12.28 11:32,close,2812,0.01,0.91892,0.97,19942.88,AUDCHF
5598,2009.12.28 11:32,close,2795,0.01,0.91892,-4.85,19938.03,AUDCHF
5599,2009.12.28 11:32,close,2794,0.01,0.91892,-4.86,19933.17,AUDCHF
5600,2009.12.28 11:32,close,2784,0.01,0.91892,-11.63,19921.54,AUDCHF
5601,2009.12.28 11:32,close,2776,0.01,0.91892,-13.43,19908.11,AUDCHF
5602,2009.12.28 11:32,close,2775,0.01,0.91892,-13.44,19894.67,AUDCHF
5603,2009.12.28 11:32,close,2764,0.01,0.91892,-14.94,19879.73,AUDCHF
5604,2009.12.28 11:32,close,2753,0.01,0.91892,-16.30,19863.43,AUDCHF
5605,2009.12.28 11:32,close,2752,0.01,0.91892,-16.32,19847.11,AUDCHF
5606,2009.12.28 11:32,close,2751,0.01,0.91892,-16.33,19830.78,AUDCHF
5607,2009.12.28 11:32,close,2738,0.01,0.91892,-26.02,19804.76,AUDCHF
5608,2009.12.28 11:32,close,2828,0.01,81.2300,9.74,19814.50,AUDJPY
5609,2009.12.28 11:32,close,2821,0.01,81.2300,9.06,19823.56,AUDJPY
5610,2009.12.28 11:32,close,2805,0.01,81.2300,10.42,19833.98,AUDJPY
5611,2009.12.28 11:32,close,2804,0.01,81.2300,10.41,19844.39,AUDJPY
5612,2009.12.28 11:32,close,2791,0.01,81.2300,22.11,19866.50,AUDJPY
5613,2009.12.28 11:32,close,2790,0.01,81.2300,22.10,19888.60,AUDJPY
5614,2009.12.28 11:32,close,2787,0.01,81.2300,15.63,19904.23,AUDJPY
5615,2009.12.28 11:32,close,2778,0.01,81.2300,14.57,19918.80,AUDJPY
5616,2009.12.28 11:32,close,2777,0.01,81.2300,14.55,19933.35,AUDJPY
5617,2009.12.28 11:32,close,2766,0.01,81.2300,6.39,19939.74,AUDJPY
5618,2009.12.28 11:32,close,2756,0.01,81.2300,6.74,19946.48,AUDJPY
5619,2009.12.28 11:32,close,2755,0.01,81.2300,6.61,19953.09,AUDJPY
5620,2009.12.28 11:32,close,2754,0.01,81.2300,6.50,19959.59,AUDJPY
5621,2009.12.28 11:32,close,2739,0.01,81.2300,3.54,19963.13,AUDJPY
5622,2009.12.28 11:32,close,2829,0.01,1.25171,1.48,19964.61,AUDNZD
5623,2009.12.28 11:32,close,2823,0.01,1.25171,1.36,19965.97,AUDNZD
5624,2009.12.28 11:32,close,2815,0.01,1.25171,3.60,19969.57,AUDNZD
5625,2009.12.28 11:32,close,2814,0.01,1.25171,3.58,19973.15,AUDNZD
5626,2009.12.28 11:32,close,2800,0.01,1.25171,3.02,19976.17,AUDNZD
5627,2009.12.28 11:32,close,2799,0.01,1.25171,2.96,19979.13,AUDNZD
5628,2009.12.28 11:32,close,2788,0.01,1.25171,4.38,19983.51,AUDNZD
5629,2009.12.28 11:32,close,2780,0.01,1.25171,0.77,19984.28,AUDNZD
5630,2009.12.28 11:32,close,2779,0.01,1.25171,0.77,19985.05,AUDNZD
5631,2009.12.28 11:32,close,2767,0.01,1.25171,3.14,19988.19,AUDNZD
5632,2009.12.28 11:32,close,2759,0.01,1.25171,-0.09,19988.10,AUDNZD
5633,2009.12.28 11:32,close,2758,0.01,1.25171,-0.07,19988.03,AUDNZD
5634,2009.12.28 11:32,close,2757,0.01,1.25171,-0.11,19987.92,AUDNZD
5635,2009.12.28 11:32,close,2740,0.01,1.25171,-5.36,19982.56,AUDNZD
5636,2009.12.28 11:32,close,2830,0.01,0.88780,13.47,19996.03,AUDUSD
5637,2009.12.28 11:32,close,2824,0.01,0.88780,12.93,20008.96,AUDUSD
5638,2009.12.28 11:32,close,2817,0.01,0.88780,9.28,20018.24,AUDUSD
5639,2009.12.28 11:32,close,2816,0.01,0.88780,9.26,20027.50,AUDUSD
5640,2009.12.28 11:32,close,2802,0.01,0.88780,1.74,20029.24,AUDUSD
5641,2009.12.28 11:32,close,2801,0.01,0.88780,1.78,20031.02,AUDUSD
5642,2009.12.28 11:32,close,2789,0.01,0.88780,1.63,20032.65,AUDUSD
5643,2009.12.28 11:32,close,2782,0.01,0.88780,-2.67,20029.98,AUDUSD
5644,2009.12.28 11:32,close,2781,0.01,0.88780,-2.60,20027.38,AUDUSD
5645,2009.12.28 11:32,close,2768,0.01,0.88780,-12.73,20014.65,AUDUSD
5646,2009.12.28 11:32,close,2761,0.01,0.88780,-10.84,20003.81,AUDUSD
5647,2009.12.28 11:32,close,2760,0.02,0.88780,-21.70,19982.11,AUDUSD
5648,2009.12.28 11:32,close,2741,0.01,0.88780,-20.25,19961.86,AUDUSD
5649,2009.12.28 11:32,close,2825,0.01,1.79840,24.97,19986.83,GBPAUD
5650,2009.12.28 11:32,close,2818,0.01,1.79840,23.87,20010.70,GBPAUD
5651,2009.12.28 11:32,close,2809,0.01,1.79840,29.65,20040.35,GBPAUD
5652,2009.12.28 11:32,close,2806,0.01,1.79840,29.63,20069.98,GBPAUD
5653,2009.12.28 11:32,close,2803,0.01,1.79840,26.15,20096.13,GBPAUD
5654,2009.12.28 11:32,close,2797,0.01,1.79840,26.14,20122.27,GBPAUD
5655,2009.12.28 11:32,close,2783,0.01,1.79840,19.78,20142.05,GBPAUD
5656,2009.12.28 11:32,close,2772,0.01,1.79840,25.80,20167.85,GBPAUD
5657,2009.12.28 11:32,close,2771,0.01,1.79840,25.79,20193.64,GBPAUD
5658,2009.12.28 11:32,close,2762,0.01,1.79840,19.40,20213.04,GBPAUD
5659,2009.12.28 11:32,close,2744,0.01,1.79840,18.90,20231.94,GBPAUD
5660,2009.12.28 11:32,close,2743,0.01,1.79840,18.88,20250.82,GBPAUD
5661,2009.12.28 11:32,close,2742,0.01,1.79840,18.86,20269.68,GBPAUD
5662,2009.12.28 11:32,close,2736,0.01,1.79840,-6.21,20263.47,GBPAUD
5663,2010.01.08 04:25,buy,2832,0.01,85.3570,,,AUDJPY
5664,2010.01.08 04:28,sell,2833,0.01,1.56305,,,EURAUD
5665,2010.01.08 04:29,buy,2834,0.01,1.25079,,,AUDNZD
5666,2010.01.08 04:29,sell,2835,0.01,1.73974,,,GBPAUD
5667,2010.01.08 04:30,buy,2836,0.01,0.94744,,,AUDCAD
5668,2010.01.08 04:30,buy,2837,0.01,0.94687,,,AUDCHF
5669,2010.01.08 04:30,buy,2838,0.01,0.91549,,,AUDUSD
5670,2010.01.08 07:25,sell,2839,0.01,1.56523,,,EURAUD
5671,2010.01.08 07:29,buy,2840,0.01,0.94612,,,AUDCAD
5672,2010.01.08 07:29,buy,2841,0.01,0.94616,,,AUDCHF
5673,2010.01.08 07:29,buy,2842,0.01,85.3680,,,AUDJPY
5674,2010.01.08 07:29,buy,2843,0.01,1.25140,,,AUDNZD
5675,2010.01.08 07:29,sell,2844,0.01,1.74399,,,GBPAUD
5676,2010.01.08 07:30,buy,2845,0.01,0.91484,,,AUDUSD
5677,2010.01.08 18:55,close,2839,0.01,1.55950,5.90,20269.37,EURAUD
5678,2010.01.08 18:55,close,2833,0.01,1.55950,3.66,20273.03,EURAUD
5679,2010.01.08 18:58,close,2840,0.01,0.95165,5.49,20278.52,AUDCAD
5680,2010.01.08 18:58,close,2836,0.01,0.95165,4.18,20282.70,AUDCAD
5681,2010.01.08 18:59,close,2841,0.01,0.94702,0.92,20283.62,AUDCHF
5682,2010.01.08 18:59,close,2837,0.01,0.94702,0.16,20283.78,AUDCHF
5683,2010.01.08 18:59,close,2842,0.01,85.4550,0.88,20284.66,AUDJPY
5684,2010.01.08 18:59,close,2832,0.01,85.4550,0.99,20285.65,AUDJPY
5685,2010.01.08 18:59,close,2843,0.01,1.25365,1.93,20287.58,AUDNZD
5686,2010.01.08 18:59,close,2834,0.01,1.25365,2.45,20290.03,AUDNZD
5687,2010.01.08 18:59,close,2844,0.01,1.73412,10.17,20300.20,GBPAUD
5688,2010.01.08 18:59,close,2835,0.01,1.73412,5.79,20305.99,GBPAUD
5689,2010.01.08 19:00,close,2845,0.01,0.92303,8.19,20314.18,AUDUSD
5690,2010.01.08 19:00,close,2838,0.01,0.92303,7.54,20321.72,AUDUSD
5691,2010.01.11 17:59,sell,2846,0.01,1.73672,,,GBPAUD
5692,2010.01.11 18:04,buy,2847,0.01,0.95915,,,AUDCAD
5693,2010.01.11 18:04,buy,2848,0.01,0.94429,,,AUDCHF
5694,2010.01.11 18:04,buy,2849,0.01,85.4250,,,AUDJPY
5695,2010.01.11 18:04,buy,2850,0.01,1.25263,,,AUDNZD
5696,2010.01.11 18:04,buy,2851,0.01,0.92969,,,AUDUSD
5697,2010.01.11 18:04,sell,2852,0.01,1.56350,,,EURAUD
5698,2010.01.12 03:47,sell,2853,0.01,1.56322,,,EURAUD
5699,2010.01.12 03:50,buy,2854,0.01,85.4000,,,AUDJPY
5700,2010.01.12 03:52,buy,2855,0.01,0.95793,,,AUDCAD
5701,2010.01.12 03:52,buy,2856,0.01,0.94324,,,AUDCHF
5702,2010.01.12 03:52,buy,2857,0.01,1.25154,,,AUDNZD
5703,2010.01.12 03:52,buy,2858,0.01,0.92523,,,AUDUSD
5704,2010.01.12 03:52,sell,2859,0.01,1.73749,,,GBPAUD
5705,2010.01.12 11:11,sell,2860,0.01,1.74096,,,GBPAUD
5706,2010.01.12 11:16,buy,2861,0.01,0.95762,,,AUDCAD
5707,2010.01.12 11:16,buy,2862,0.01,0.94363,,,AUDCHF
5708,2010.01.12 11:16,buy,2863,0.01,84.9990,,,AUDJPY
5709,2010.01.12 11:16,buy,2864,0.01,1.24937,,,AUDNZD
5710,2010.01.12 11:16,buy,2865,0.01,0.92668,,,AUDUSD
5711,2010.01.12 11:16,sell,2866,0.01,1.56418,,,EURAUD
5712,2010.01.12 16:25,sell,2867,0.01,1.74753,,,GBPAUD
5713,2010.01.12 16:26,sell,2868,0.01,1.74701,,,GBPAUD
5714,2010.01.12 16:28,sell,2869,0.01,1.56895,,,EURAUD
5715,2010.01.12 16:29,buy,2870,0.01,0.95982,,,AUDCAD
5716,2010.01.12 16:29,buy,2871,0.01,0.94029,,,AUDCHF
5717,2010.01.12 16:29,buy,2872,0.01,84.3730,,,AUDJPY
5718,2010.01.12 16:29,buy,2873,0.01,1.24827,,,AUDNZD
5719,2010.01.12 16:29,sell,2874,0.01,1.56892,,,EURAUD
5720,2010.01.12 16:30,buy,2875,0.01,0.95957,,,AUDCAD
5721,2010.01.12 16:30,buy,2876,0.01,0.94020,,,AUDCHF
5722,2010.01.12 16:30,buy,2877,0.01,84.3370,,,AUDJPY
5723,2010.01.12 16:30,buy,2878,0.01,1.24836,,,AUDNZD
5724,2010.01.12 16:30,buy,2879,0.01,0.92561,,,AUDUSD
5725,2010.01.12 16:30,buy,2880,0.01,0.92536,,,AUDUSD
5726,2010.01.12 17:41,sell,2881,0.01,1.74884,,,GBPAUD
5727,2010.01.12 17:45,buy,2882,0.01,84.0450,,,AUDJPY
5728,2010.01.12 17:45,sell,2883,0.01,1.57076,,,EURAUD
5729,2010.01.12 17:46,buy,2884,0.01,0.95901,,,AUDCAD
5730,2010.01.12 17:46,buy,2885,0.01,0.93960,,,AUDCHF
5731,2010.01.12 17:46,buy,2886,0.01,1.24693,,,AUDNZD
5732,2010.01.12 17:46,buy,2887,0.01,0.92483,,,AUDUSD
5733,2010.01.12 23:25,sell,2888,0.01,1.57349,,,EURAUD
5734,2010.01.12 23:25,sell,2889,0.01,1.57350,,,EURAUD
5735,2010.01.12 23:26,buy,2890,0.01,0.93729,,,AUDCHF
5736,2010.01.12 23:26,buy,2891,0.01,83.8310,,,AUDJPY
5737,2010.01.12 23:26,buy,2892,0.01,83.8350,,,AUDJPY
5738,2010.01.12 23:27,buy,2893,0.01,0.93727,,,AUDCHF
5739,2010.01.12 23:27,buy,2894,0.01,1.24520,,,AUDNZD
5740,2010.01.12 23:27,buy,2895,0.01,1.24523,,,AUDNZD
5741,2010.01.12 23:29,buy,2896,0.01,0.95685,,,AUDCAD
5742,2010.01.12 23:29,buy,2897,0.01,0.95684,,,AUDCAD
5743,2010.01.12 23:30,buy,2898,0.01,0.92042,,,AUDUSD
5744,2010.01.12 23:30,buy,2899,0.01,0.92044,,,AUDUSD
5745,2010.01.12 23:30,sell,2900,0.01,1.75457,,,GBPAUD
5746,2010.01.12 23:30,sell,2901,0.01,1.75444,,,GBPAUD
5747,2010.01.14 10:55,close,2901,0.01,1.75157,3.35,20325.07,GBPAUD
5748,2010.01.14 10:55,close,2900,0.01,1.75157,3.49,20328.56,GBPAUD
5749,2010.01.14 10:55,close,2881,0.01,1.75157,-2.42,20326.14,GBPAUD
5750,2010.01.14 10:55,close,2868,0.01,1.75157,-4.30,20321.84,GBPAUD
5751,2010.01.14 10:55,close,2867,0.01,1.75157,-3.77,20318.07,GBPAUD
5752,2010.01.14 10:55,close,2860,0.01,1.75157,-10.53,20307.54,GBPAUD
5753,2010.01.14 10:55,close,2859,0.01,1.75157,-14.11,20293.43,GBPAUD
5754,2010.01.14 10:55,close,2846,0.01,1.75157,-14.81,20278.62,GBPAUD
5755,2010.01.14 10:58,close,2893,0.01,0.94837,12.13,20290.75,AUDCHF
5756,2010.01.14 10:58,close,2890,0.01,0.94837,12.11,20302.86,AUDCHF
5757,2010.01.14 10:58,close,2885,0.01,0.94837,9.64,20312.50,AUDCHF
5758,2010.01.14 10:58,close,2876,0.01,0.94837,8.99,20321.49,AUDCHF
5759,2010.01.14 10:58,close,2871,0.01,0.94837,8.90,20330.39,AUDCHF
5760,2010.01.14 10:58,close,2862,0.01,0.94837,5.33,20335.72,AUDCHF
5761,2010.01.14 10:58,close,2856,0.01,0.94837,5.74,20341.46,AUDCHF
5762,2010.01.14 10:58,close,2848,0.01,0.94837,4.68,20346.14,AUDCHF
5763,2010.01.14 10:58,close,2895,0.01,1.25103,4.94,20351.08,AUDNZD
5764,2010.01.14 10:58,close,2894,0.01,1.25103,4.97,20356.05,AUDNZD
5765,2010.01.14 10:58,close,2886,0.01,1.25103,3.49,20359.54,AUDNZD
5766,2010.01.14 10:58,close,2878,0.01,1.25103,2.27,20361.81,AUDNZD
5767,2010.01.14 10:58,close,2873,0.01,1.25103,2.35,20364.16,AUDNZD
5768,2010.01.14 10:58,close,2864,0.01,1.25103,1.41,20365.57,AUDNZD
5769,2010.01.14 10:58,close,2857,0.01,1.25103,-0.44,20365.13,AUDNZD
5770,2010.01.14 10:58,close,2850,0.01,1.25103,-1.37,20363.76,AUDNZD
5771,2010.01.14 10:58,close,2889,0.01,1.56070,13.57,20377.33,EURAUD
5772,2010.01.14 10:58,close,2888,0.01,1.56070,13.56,20390.89,EURAUD
5773,2010.01.14 10:58,close,2883,0.01,1.56070,10.75,20401.64,EURAUD
5774,2010.01.14 10:58,close,2874,0.01,1.56070,8.86,20410.50,EURAUD
5775,2010.01.14 10:58,close,2869,0.01,1.56070,8.89,20419.39,EURAUD
5776,2010.01.14 10:58,close,2866,0.01,1.56070,3.97,20423.36,EURAUD
5777,2010.01.14 10:58,close,2853,0.01,1.56070,2.98,20426.34,EURAUD
5778,2010.01.14 10:58,close,2852,0.01,1.56070,3.37,20429.71,EURAUD
5779,2010.01.14 10:59,close,2897,0.01,0.95737,0.69,20430.40,AUDCAD
5780,2010.01.14 10:59,close,2896,0.01,0.95737,0.68,20431.08,AUDCAD
5781,2010.01.14 10:59,close,2884,0.01,0.95737,-1.46,20429.62,AUDCAD
5782,2010.01.14 10:59,close,2875,0.01,0.95737,-2.01,20427.61,AUDCAD
5783,2010.01.14 10:59,close,2870,0.01,0.95737,-2.26,20425.35,AUDCAD
5784,2010.01.14 10:59,close,2861,0.01,0.95737,-0.08,20425.27,AUDCAD
5785,2010.01.14 10:59,close,2855,0.01,0.95737,-0.39,20424.88,AUDCAD
5786,2010.01.14 10:59,close,2847,0.01,0.95737,-1.56,20423.32,AUDCAD
5787,2010.01.14 10:59,close,2892,0.01,85.3930,16.00,20439.32,AUDJPY
5788,2010.01.14 10:59,close,2891,0.01,85.3930,16.04,20455.36,AUDJPY
5789,2010.01.14 10:59,close,2882,0.01,85.3930,13.88,20469.24,AUDJPY
5790,2010.01.14 10:59,close,2877,0.01,85.3930,10.94,20480.18,AUDJPY
5791,2010.01.14 10:59,close,2872,0.01,85.3930,10.57,20490.75,AUDJPY
5792,2010.01.14 10:59,close,2863,0.01,85.3930,4.26,20495.01,AUDJPY
5793,2010.01.14 10:59,close,2854,0.01,85.3930,0.22,20495.23,AUDJPY
5794,2010.01.14 10:59,close,2849,0.01,85.3930,0.03,20495.26,AUDJPY
5795,2010.01.14 11:00,close,2899,0.01,0.92932,9.14,20504.40,AUDUSD
5796,2010.01.14 11:00,close,2898,0.01,0.92932,9.16,20513.56,AUDUSD
5797,2010.01.14 11:00,close,2887,0.01,0.92932,4.75,20518.31,AUDUSD
5798,2010.01.14 11:00,close,2880,0.01,0.92932,4.22,20522.53,AUDUSD
5799,2010.01.14 11:00,close,2879,0.01,0.92932,3.97,20526.50,AUDUSD
5800,2010.01.14 11:00,close,2865,0.01,0.92932,2.90,20529.40,AUDUSD
5801,2010.01.14 11:00,close,2858,0.01,0.92932,4.35,20533.75,AUDUSD
5802,2010.01.14 11:00,close,2851,0.01,0.92932,-0.04,20533.71,AUDUSD
5803,2010.01.15 03:55,sell,2902,0.01,1.75909,,,GBPAUD
5804,2010.01.15 03:58,sell,2903,0.01,1.55610,,,EURAUD
5805,2010.01.15 03:59,buy,2904,0.01,0.95111,,,AUDCAD
5806,2010.01.15 03:59,buy,2905,0.01,0.94824,,,AUDCHF
5807,2010.01.15 03:59,buy,2906,0.01,84.3920,,,AUDJPY
5808,2010.01.15 04:00,buy,2907,0.01,1.25520,,,AUDNZD
5809,2010.01.15 04:00,buy,2908,0.01,0.92672,,,AUDUSD
5810,2010.01.15 09:25,sell,2909,0.01,1.76244,,,GBPAUD
5811,2010.01.15 09:27,buy,2910,0.01,0.94853,,,AUDCHF
5812,2010.01.15 09:29,buy,2911,0.01,0.95033,,,AUDCAD
5813,2010.01.15 09:29,buy,2912,0.01,83.9580,,,AUDJPY
5814,2010.01.15 09:29,buy,2913,0.01,1.25415,,,AUDNZD
5815,2010.01.15 09:29,sell,2914,0.01,1.55538,,,EURAUD
5816,2010.01.15 09:30,buy,2915,0.01,0.92576,,,AUDUSD
5817,2010.01.15 18:55,sell,2916,0.01,1.76012,,,GBPAUD
5818,2010.01.15 18:58,buy,2917,0.01,0.94706,,,AUDCHF
5819,2010.01.15 18:59,buy,2918,0.01,0.94961,,,AUDCAD
5820,2010.01.15 18:59,sell,2919,0.01,1.55811,,,EURAUD
5821,2010.01.15 19:00,buy,2920,0.01,83.7940,,,AUDJPY
5822,2010.01.15 19:00,buy,2921,0.01,1.25066,,,AUDNZD
5823,2010.01.15 19:00,buy,2922,0.01,0.92293,,,AUDUSD
5824,2010.01.18 04:55,sell,2923,0.01,1.77117,,,GBPAUD
5825,2010.01.18 04:57,buy,2924,0.01,0.94682,,,AUDCHF
5826,2010.01.18 04:58,buy,2925,0.01,83.7230,,,AUDJPY
5827,2010.01.18 04:58,buy,2926,0.01,1.25073,,,AUDNZD
5828,2010.01.18 04:58,sell,2927,0.01,1.55989,,,EURAUD
5829,2010.01.18 04:59,buy,2928,0.01,0.94723,,,AUDCAD
5830,2010.01.18 05:00,buy,2929,0.01,0.92081,,,AUDUSD
5831,2010.01.18 12:25,close,2923,0.01,1.76448,6.89,20540.60,GBPAUD
5832,2010.01.18 12:25,close,2916,0.01,1.76448,-4.39,20536.21,GBPAUD
5833,2010.01.18 12:25,close,2909,0.01,1.76448,-2.00,20534.21,GBPAUD
5834,2010.01.18 12:25,close,2902,0.01,1.76448,-5.45,20528.76,GBPAUD
5835,2010.01.18 12:29,close,2924,0.01,0.94907,2.41,20531.17,AUDCHF
5836,2010.01.18 12:29,close,2917,0.01,0.94907,2.21,20533.38,AUDCHF
5837,2010.01.18 12:29,close,2910,0.01,0.94907,0.64,20534.02,AUDCHF
5838,2010.01.18 12:29,close,2905,0.01,0.94907,0.95,20534.97,AUDCHF
5839,2010.01.18 12:30,close,2928,0.01,0.95051,3.26,20538.23,AUDCAD
5840,2010.01.18 12:30,close,2918,0.01,0.95051,0.94,20539.17,AUDCAD
5841,2010.01.18 12:30,close,2911,0.01,0.95051,0.22,20539.39,AUDCAD
5842,2010.01.18 12:30,close,2904,0.01,0.95051,-0.55,20538.84,AUDCAD
5843,2010.01.18 12:30,close,2925,0.01,83.9480,2.27,20541.11,AUDJPY
5844,2010.01.18 12:30,close,2920,0.01,83.9480,1.62,20542.73,AUDJPY
5845,2010.01.18 12:30,close,2912,0.01,83.9480,-0.03,20542.70,AUDJPY
5846,2010.01.18 12:30,close,2906,0.01,83.9480,-4.41,20538.29,AUDJPY
5847,2010.01.18 12:30,close,2926,0.01,1.25340,2.28,20540.57,AUDNZD
5848,2010.01.18 12:30,close,2921,0.01,1.25340,2.34,20542.91,AUDNZD
5849,2010.01.18 12:30,close,2913,0.01,1.25340,-0.64,20542.27,AUDNZD
5850,2010.01.18 12:30,close,2907,0.01,1.25340,-1.54,20540.73,AUDNZD
5851,2010.01.18 12:30,close,2929,0.01,0.92515,4.34,20545.07,AUDUSD
5852,2010.01.18 12:30,close,2922,0.01,0.92515,2.29,20547.36,AUDUSD
5853,2010.01.18 12:30,close,2915,0.01,0.92515,-0.54,20546.82,AUDUSD
5854,2010.01.18 12:30,close,2908,0.01,0.92515,-1.51,20545.31,AUDUSD
5855,2010.01.18 12:30,close,2927,0.01,1.55351,6.57,20551.88,EURAUD
5856,2010.01.18 12:30,close,2919,0.01,1.55351,4.84,20556.72,EURAUD
5857,2010.01.18 12:30,close,2914,0.01,1.55351,2.02,20558.74,EURAUD
5858,2010.01.18 12:30,close,2903,0.01,1.55351,2.77,20561.51,EURAUD
5859,2010.01.19 07:25,buy,2930,0.01,0.94732,,,AUDCHF
5860,2010.01.19 07:26,sell,2931,0.01,1.55706,,,EURAUD
5861,2010.01.19 07:28,sell,2932,0.01,1.77482,,,GBPAUD
5862,2010.01.19 07:29,buy,2933,0.01,0.94890,,,AUDCAD
5863,2010.01.19 07:29,buy,2934,0.01,83.6490,,,AUDJPY
5864,2010.01.19 07:29,buy,2935,0.01,1.25141,,,AUDNZD
5865,2010.01.19 07:30,buy,2936,0.01,0.92439,,,AUDUSD
5866,2010.01.19 19:25,close,2932,0.01,1.77227,2.62,20564.13,GBPAUD
5867,2010.01.19 19:27,close,2930,0.01,0.95374,6.86,20570.99,AUDCHF
5868,2010.01.19 19:27,close,2931,0.01,1.54600,11.39,20582.38,EURAUD
5869,2010.01.19 19:28,close,2933,0.01,0.95336,4.42,20586.80,AUDCAD
5870,2010.01.19 19:28,close,2934,0.01,84.1860,5.42,20592.22,AUDJPY
5871,2010.01.19 19:29,close,2935,0.01,1.25038,-0.88,20591.34,AUDNZD
5872,2010.01.19 19:30,close,2936,0.01,0.92406,-0.33,20591.01,AUDUSD
5873,2010.01.20 09:40,sell,2937,0.01,1.77824,,,GBPAUD
5874,2010.01.20 09:42,sell,2938,0.01,1.54932,,,EURAUD
5875,2010.01.20 09:45,buy,2939,0.01,0.94859,,,AUDCAD
5876,2010.01.20 09:45,buy,2940,0.01,0.95185,,,AUDCHF
5877,2010.01.20 09:45,buy,2941,0.01,83.3460,,,AUDJPY
5878,2010.01.20 09:45,buy,2942,0.01,1.25946,,,AUDNZD
5879,2010.01.20 09:45,buy,2943,0.01,0.91657,,,AUDUSD
5880,2010.01.20 21:25,sell,2944,0.01,1.79175,,,GBPAUD
5881,2010.01.20 21:25,sell,2945,0.01,1.79171,,,GBPAUD
5882,2010.01.20 21:26,buy,2946,0.01,0.95162,,,AUDCAD
5883,2010.01.20 21:26,buy,2947,0.01,0.95167,,,AUDCAD
5884,2010.01.20 21:29,sell,2948,0.01,1.55180,,,EURAUD
5885,2010.01.20 21:29,sell,2949,0.01,1.55171,,,EURAUD
5886,2010.01.20 21:30,buy,2950,0.01,0.94879,,,AUDCHF
5887,2010.01.20 21:30,buy,2951,0.01,0.94879,,,AUDCHF
5888,2010.01.20 21:30,buy,2952,0.01,82.9040,,,AUDJPY
5889,2010.01.20 21:30,buy,2953,0.01,82.9030,,,AUDJPY
5890,2010.01.20 21:30,buy,2954,0.01,1.26088,,,AUDNZD
5891,2010.01.20 21:30,buy,2955,0.01,1.26089,,,AUDNZD
5892,2010.01.20 21:30,buy,2956,0.01,0.90865,,,AUDUSD
5893,2010.01.20 21:30,buy,2957,0.01,0.90869,,,AUDUSD
5894,2010.01.21 03:55,close,2949,0.01,1.54632,5.84,20596.85,EURAUD
5895,2010.01.21 03:55,close,2948,0.01,1.54632,5.93,20602.78,EURAUD
5896,2010.01.21 03:55,close,2938,0.01,1.54632,3.38,20606.16,EURAUD
5897,2010.01.21 03:59,close,2947,0.01,0.95279,1.24,20607.40,AUDCAD
5898,2010.01.21 03:59,close,2946,0.01,0.95279,1.29,20608.69,AUDCAD
5899,2010.01.21 03:59,close,2939,0.01,0.95279,4.30,20612.99,AUDCAD
5900,2010.01.21 03:59,close,2951,0.01,0.95146,3.04,20616.03,AUDCHF
5901,2010.01.21 03:59,close,2950,0.01,0.95146,3.04,20619.07,AUDCHF
5902,2010.01.21 03:59,close,2940,0.01,0.95146,-0.23,20618.84,AUDCHF
5903,2010.01.21 03:59,close,2953,0.01,83.2020,3.24,20622.08,AUDJPY
5904,2010.01.21 03:59,close,2952,0.01,83.2020,3.23,20625.31,AUDJPY
5905,2010.01.21 03:59,close,2941,0.01,83.2020,-1.23,20624.08,AUDJPY
5906,2010.01.21 03:59,close,2955,0.01,1.26395,2.60,20626.68,AUDNZD
5907,2010.01.21 03:59,close,2954,0.01,1.26395,2.61,20629.29,AUDNZD
5908,2010.01.21 03:59,close,2942,0.01,1.26395,3.83,20633.12,AUDNZD
5909,2010.01.21 03:59,close,2945,0.01,1.78500,7.22,20640.34,GBPAUD
5910,2010.01.21 03:59,close,2944,0.01,1.78500,7.26,20647.60,GBPAUD
5911,2010.01.21 03:59,close,2937,0.01,1.78500,-6.66,20640.94,GBPAUD
5912,2010.01.21 04:00,close,2957,0.01,0.91028,1.79,20642.73,AUDUSD
5913,2010.01.21 04:00,close,2956,0.01,0.91028,1.83,20644.56,AUDUSD
5914,2010.01.21 04:00,close,2943,0.01,0.91028,-6.09,20638.47,AUDUSD
5915,2010.01.22 00:55,buy,2958,0.01,81.6950,,,AUDJPY
5916,2010.01.22 00:58,buy,2959,0.01,0.94253,,,AUDCHF
5917,2010.01.22 00:58,sell,2960,0.01,1.55846,,,EURAUD
5918,2010.01.22 00:58,sell,2961,0.01,1.79052,,,GBPAUD
5919,2010.01.22 00:59,buy,2962,0.01,0.95048,,,AUDCAD
5920,2010.01.22 00:59,buy,2963,0.01,1.26736,,,AUDNZD
5921,2010.01.22 01:00,buy,2964,0.01,0.90415,,,AUDUSD
5922,2010.01.22 01:01,buy,2965,0.01,81.6100,,,AUDJPY
5923,2010.01.22 01:06,buy,2966,0.01,0.94945,,,AUDCAD
5924,2010.01.22 01:06,buy,2967,0.01,0.94177,,,AUDCHF
5925,2010.01.22 01:06,buy,2968,0.01,1.26637,,,AUDNZD
5926,2010.01.22 01:06,buy,2969,0.01,0.90312,,,AUDUSD
5927,2010.01.22 01:06,sell,2970,0.01,1.55991,,,EURAUD
5928,2010.01.22 01:06,sell,2971,0.01,1.79279,,,GBPAUD
5929,2010.01.22 03:55,buy,2972,0.01,81.1180,,,AUDJPY
5930,2010.01.22 03:58,sell,2973,0.01,1.56519,,,EURAUD
5931,2010.01.22 03:59,buy,2974,0.01,0.94857,,,AUDCAD
5932,2010.01.22 03:59,buy,2975,0.01,0.93961,,,AUDCHF
5933,2010.01.22 03:59,sell,2976,0.01,1.79476,,,GBPAUD
5934,2010.01.22 04:00,buy,2977,0.01,1.26643,,,AUDNZD
5935,2010.01.22 04:00,buy,2978,0.01,0.90283,,,AUDUSD
5936,2010.01.22 09:25,close,2976,0.01,1.79072,4.16,20642.63,GBPAUD
5937,2010.01.22 09:25,close,2971,0.01,1.79072,2.13,20644.76,GBPAUD
5938,2010.01.22 09:25,close,2961,0.01,1.79072,-0.21,20644.55,GBPAUD
5939,2010.01.22 09:28,close,2973,0.01,1.55766,7.76,20652.31,EURAUD
5940,2010.01.22 09:28,close,2970,0.01,1.55766,2.32,20654.63,EURAUD
5941,2010.01.22 09:28,close,2960,0.01,1.55766,0.83,20655.46,EURAUD
5942,2010.01.22 09:30,close,2974,0.01,0.95091,2.32,20657.78,AUDCAD
5943,2010.01.22 09:30,close,2966,0.01,0.95091,1.44,20659.22,AUDCAD
5944,2010.01.22 09:30,close,2962,0.01,0.95091,0.42,20659.64,AUDCAD
5945,2010.01.22 09:30,close,2975,0.01,0.94402,4.72,20664.36,AUDCHF
5946,2010.01.22 09:30,close,2967,0.01,0.94402,2.41,20666.77,AUDCHF
5947,2010.01.22 09:30,close,2959,0.01,0.94402,1.59,20668.36,AUDCHF
5948,2010.01.22 09:30,close,2972,0.01,81.9980,8.87,20677.23,AUDJPY
5949,2010.01.22 09:30,close,2965,0.01,81.9980,3.91,20681.14,AUDJPY
5950,2010.01.22 09:30,close,2958,0.01,81.9980,3.05,20684.19,AUDJPY
5951,2010.01.22 09:30,close,2977,0.01,1.26741,0.84,20685.03,AUDNZD
5952,2010.01.22 09:30,close,2968,0.01,1.26741,0.89,20685.92,AUDNZD
5953,2010.01.22 09:30,close,2963,0.01,1.26741,0.04,20685.96,AUDNZD
5954,2010.01.22 09:30,close,2978,0.01,0.90778,4.95,20690.91,AUDUSD
5955,2010.01.22 09:30,close,2969,0.01,0.90778,4.66,20695.57,AUDUSD
5956,2010.01.22 09:30,close,2964,0.01,0.90778,3.63,20699.20,AUDUSD
5957,2010.01.22 22:25,buy,2979,0.01,0.93837,,,AUDCHF
5958,2010.01.22 22:27,buy,2980,0.01,80.9260,,,AUDJPY
5959,2010.01.22 22:27,sell,2981,0.01,1.56907,,,EURAUD
5960,2010.01.22 22:27,sell,2982,0.01,1.78883,,,GBPAUD
5961,2010.01.22 22:28,buy,2983,0.01,0.95344,,,AUDCAD
5962,2010.01.22 22:29,buy,2984,0.01,1.26781,,,AUDNZD
5963,2010.01.22 22:30,buy,2985,0.01,0.90100,,,AUDUSD
5964,2010.01.26 02:55,close,2982,0.01,1.79192,-2.98,20696.22,GBPAUD
5965,2010.01.26 02:59,close,2979,0.01,0.94197,3.98,20700.20,AUDCHF
5966,2010.01.26 02:59,close,2980,0.01,82.0830,11.82,20712.02,AUDJPY
5967,2010.01.26 03:00,close,2983,0.01,0.95724,3.86,20715.88,AUDCAD
5968,2010.01.26 03:00,close,2984,0.01,1.26570,-1.81,20714.07,AUDNZD
5969,2010.01.26 03:00,close,2985,0.01,0.90721,6.34,20720.41,AUDUSD
5970,2010.01.26 03:00,close,2981,0.01,1.56173,7.76,20728.17,EURAUD
5971,2010.01.26 05:25,sell,2986,0.01,1.79731,,,GBPAUD
5972,2010.01.26 05:28,sell,2987,0.01,1.56375,,,EURAUD
5973,2010.01.26 05:29,buy,2988,0.01,0.95516,,,AUDCAD
5974,2010.01.26 05:29,buy,2989,0.01,0.94066,,,AUDCHF
5975,2010.01.26 05:29,buy,2990,0.01,81.3020,,,AUDJPY
5976,2010.01.26 05:29,buy,2991,0.01,1.26661,,,AUDNZD
5977,2010.01.26 05:30,buy,2992,0.01,0.90219,,,AUDUSD
5978,2010.01.26 05:46,sell,2993,0.01,1.79908,,,GBPAUD
5979,2010.01.26 05:48,sell,2994,0.01,1.56459,,,EURAUD
5980,2010.01.26 05:50,buy,2995,0.01,81.0840,,,AUDJPY
5981,2010.01.26 05:51,buy,2996,0.01,0.95418,,,AUDCAD
5982,2010.01.26 05:51,buy,2997,0.01,0.94034,,,AUDCHF
5983,2010.01.26 05:51,buy,2998,0.01,1.26645,,,AUDNZD
5984,2010.01.26 05:51,buy,2999,0.01,0.90059,,,AUDUSD
5985,2010.01.26 05:53,sell,3000,0.01,1.56595,,,EURAUD
5986,2010.01.26 05:53,sell,3001,0.01,1.80046,,,GBPAUD
5987,2010.01.26 05:56,buy,3002,0.01,80.9400,,,AUDJPY
5988,2010.01.26 05:57,buy,3003,0.01,0.95265,,,AUDCAD
5989,2010.01.26 05:57,buy,3004,0.01,0.93882,,,AUDCHF
5990,2010.01.26 05:57,buy,3005,0.01,1.26618,,,AUDNZD
5991,2010.01.26 05:58,buy,3006,0.01,0.89849,,,AUDUSD
5992,2010.01.26 20:25,close,3001,0.01,1.79013,10.64,20738.81,GBPAUD
5993,2010.01.26 20:25,close,2993,0.01,1.79013,9.22,20748.03,GBPAUD
5994,2010.01.26 20:25,close,2986,0.01,1.79013,7.40,20755.43,GBPAUD
5995,2010.01.26 20:29,close,3003,0.01,0.95567,3.00,20758.43,AUDCAD
5996,2010.01.26 20:29,close,2996,0.01,0.95567,1.48,20759.91,AUDCAD
5997,2010.01.26 20:29,close,2988,0.01,0.95567,0.51,20760.42,AUDCAD
5998,2010.01.26 20:29,close,3004,0.01,0.94260,4.04,20764.46,AUDCHF
5999,2010.01.26 20:29,close,2997,0.01,0.94260,2.41,20766.87,AUDCHF
6000,2010.01.26 20:29,close,2989,0.01,0.94260,2.07,20768.94,AUDCHF
6001,2010.01.26 20:29,close,3002,0.01,80.7870,-1.54,20767.40,AUDJPY
6002,2010.01.26 20:29,close,2995,0.01,80.7870,-2.99,20764.41,AUDJPY
6003,2010.01.26 20:29,close,2990,0.01,80.7870,-5.19,20759.22,AUDJPY
6004,2010.01.26 20:29,close,3005,0.01,1.26917,2.55,20761.77,AUDNZD
6005,2010.01.26 20:29,close,2998,0.01,1.26917,2.32,20764.09,AUDNZD
6006,2010.01.26 20:29,close,2991,0.01,1.26917,2.18,20766.27,AUDNZD
6007,2010.01.26 20:29,close,3000,0.01,1.56267,3.37,20769.64,EURAUD
6008,2010.01.26 20:29,close,2994,0.01,1.56267,1.97,20771.61,EURAUD
6009,2010.01.26 20:29,close,2987,0.01,1.56267,1.11,20772.72,EURAUD
6010,2010.01.26 20:30,close,3006,0.01,0.90115,2.66,20775.38,AUDUSD
6011,2010.01.26 20:30,close,2999,0.01,0.90115,0.56,20775.94,AUDUSD
6012,2010.01.26 20:30,close,2992,0.01,0.90115,-1.04,20774.90,AUDUSD
6013,2010.01.27 15:25,sell,3007,0.01,1.80427,,,GBPAUD
6014,2010.01.27 15:29,buy,3008,0.01,0.95529,,,AUDCAD
6015,2010.01.27 15:29,buy,3009,0.01,0.93995,,,AUDCHF
6016,2010.01.27 15:29,buy,3010,0.01,80.2070,,,AUDJPY
6017,2010.01.27 15:29,buy,3011,0.01,1.26891,,,AUDNZD
6018,2010.01.27 15:29,sell,3012,0.01,1.56560,,,EURAUD
6019,2010.01.27 15:30,buy,3013,0.01,0.89720,,,AUDUSD
6020,2010.01.27 17:13,sell,3014,0.01,1.80633,,,GBPAUD
6021,2010.01.27 17:18,buy,3015,0.01,0.95492,,,AUDCAD
6022,2010.01.27 17:18,buy,3016,0.01,0.93909,,,AUDCHF
6023,2010.01.27 17:18,buy,3017,0.01,80.0380,,,AUDJPY
6024,2010.01.27 17:18,buy,3018,0.01,1.26927,,,AUDNZD
6025,2010.01.27 17:18,buy,3019,0.01,0.89564,,,AUDUSD
6026,2010.01.27 17:18,sell,3020,0.01,1.56713,,,EURAUD
6027,2010.01.27 20:14,sell,3021,0.01,1.80761,,,GBPAUD
6028,2010.01.27 20:16,sell,3022,0.01,1.56817,,,EURAUD
6029,2010.01.27 20:17,buy,3023,0.01,0.95348,,,AUDCAD
6030,2010.01.27 20:17,buy,3024,0.01,0.93769,,,AUDCHF
6031,2010.01.27 20:18,buy,3025,0.01,79.9600,,,AUDJPY
6032,2010.01.27 20:18,buy,3026,0.01,1.26818,,,AUDNZD
6033,2010.01.27 20:19,buy,3027,0.01,0.89372,,,AUDUSD
6034,2010.01.28 07:25,close,3024,0.01,0.94602,9.10,20784.00,AUDCHF
6035,2010.01.28 07:25,close,3016,0.01,0.94602,7.60,20791.60,AUDCHF
6036,2010.01.28 07:25,close,3009,0.01,0.94602,6.68,20798.28,AUDCHF
6037,2010.01.28 07:26,close,3022,0.01,1.55603,12.80,20811.08,EURAUD
6038,2010.01.28 07:26,close,3020,0.01,1.55603,11.73,20822.81,EURAUD
6039,2010.01.28 07:26,close,3012,0.01,1.55603,10.15,20832.96,EURAUD
6040,2010.01.28 07:27,close,3021,0.01,1.79871,9.47,20842.43,GBPAUD
6041,2010.01.28 07:27,close,3014,0.01,1.79871,8.15,20850.58,GBPAUD
6042,2010.01.28 07:27,close,3007,0.01,1.79871,6.03,20856.61,GBPAUD
6043,2010.01.28 07:28,close,3025,0.01,81.1260,11.98,20868.59,AUDJPY
6044,2010.01.28 07:28,close,3017,0.01,81.1260,11.20,20879.79,AUDJPY
6045,2010.01.28 07:28,close,3010,0.01,81.1260,9.49,20889.28,AUDJPY
6046,2010.01.28 07:29,close,3023,0.01,0.95419,0.84,20890.12,AUDCAD
6047,2010.01.28 07:29,close,3015,0.01,0.95419,-0.59,20889.53,AUDCAD
6048,2010.01.28 07:29,close,3008,0.01,0.95419,-0.96,20888.57,AUDCAD
6049,2010.01.28 07:29,close,3026,0.01,1.26922,0.88,20889.45,AUDNZD
6050,2010.01.28 07:29,close,3018,0.01,1.26922,-0.05,20889.40,AUDNZD
6051,2010.01.28 07:29,close,3011,0.01,1.26922,0.26,20889.66,AUDNZD
6052,2010.01.28 07:30,close,3027,0.01,0.89983,6.31,20895.97,AUDUSD
6053,2010.01.28 07:30,close,3019,0.01,0.89983,4.39,20900.36,AUDUSD
6054,2010.01.28 07:30,close,3013,0.01,0.89983,2.82,20903.18,AUDUSD
6055,2010.01.28 19:23,sell,3028,0.01,1.80064,,,GBPAUD
6056,2010.01.28 19:27,buy,3029,0.01,0.95421,,,AUDCAD
6057,2010.01.28 19:27,buy,3030,0.01,1.26839,,,AUDNZD
6058,2010.01.28 19:27,sell,3031,0.01,1.55988,,,EURAUD
6059,2010.01.28 19:28,buy,3032,0.01,0.94233,,,AUDCHF
6060,2010.01.28 19:28,buy,3033,0.01,80.5510,,,AUDJPY
6061,2010.01.28 19:28,buy,3034,0.01,0.89622,,,AUDUSD
6062,2010.01.29 02:55,sell,3035,0.01,1.56188,,,EURAUD
6063,2010.01.29 02:55,sell,3036,0.01,1.80811,,,GBPAUD
6064,2010.01.29 02:56,buy,3037,0.01,80.2970,,,AUDJPY
6065,2010.01.29 02:58,buy,3038,0.01,0.95424,,,AUDCAD
6066,2010.01.29 02:58,buy,3039,0.01,1.26667,,,AUDNZD
6067,2010.01.29 02:59,buy,3040,0.01,0.93994,,,AUDCHF
6068,2010.01.29 03:00,buy,3041,0.01,0.89308,,,AUDUSD
6069,2010.01.29 07:55,sell,3042,0.01,1.56378,,,EURAUD
6070,2010.01.29 07:55,sell,3043,0.01,1.81067,,,GBPAUD
6071,2010.01.29 07:58,buy,3044,0.01,0.93823,,,AUDCHF
6072,2010.01.29 07:58,buy,3045,0.01,1.26509,,,AUDNZD
6073,2010.01.29 07:59,buy,3046,0.01,0.95187,,,AUDCAD
6074,2010.01.29 07:59,buy,3047,0.01,80.2500,,,AUDJPY
6075,2010.01.29 08:00,buy,3048,0.01,0.89185,,,AUDUSD
6076,2010.01.29 18:25,sell,3049,0.01,1.80329,,,GBPAUD
6077,2010.01.29 18:27,buy,3050,0.01,0.94012,,,AUDCHF
6078,2010.01.29 18:29,sell,3051,0.01,1.56259,,,EURAUD
6079,2010.01.29 18:30,buy,3052,0.01,0.94641,,,AUDCAD
6080,2010.01.29 18:30,buy,3053,0.01,80.2760,,,AUDJPY
6081,2010.01.29 18:30,buy,3054,0.01,1.25941,,,AUDNZD
6082,2010.01.29 18:30,buy,3055,0.01,0.88726,,,AUDUSD
6083,2010.02.01 01:00,sell,3056,0.01,1.80257,,,GBPAUD
6084,2010.02.01 01:02,buy,3057,0.01,79.9690,,,AUDJPY
6085,2010.02.01 01:02,sell,3058,0.01,1.56552,,,EURAUD
6086,2010.02.01 01:05,buy,3059,0.01,0.94564,,,AUDCAD
6087,2010.02.01 01:05,buy,3060,0.01,0.93885,,,AUDCHF
6088,2010.02.01 01:05,buy,3061,0.01,1.25913,,,AUDNZD
6089,2010.02.01 01:05,buy,3062,0.01,0.88515,,,AUDUSD
6090,2010.02.01 05:55,sell,3063,0.01,1.80589,,,GBPAUD
6091,2010.02.01 05:59,buy,3064,0.01,0.94456,,,AUDCAD
6092,2010.02.01 05:59,buy,3065,0.01,0.93649,,,AUDCHF
6093,2010.02.01 05:59,buy,3066,0.01,79.6440,,,AUDJPY
6094,2010.02.01 05:59,buy,3067,0.01,1.25827,,,AUDNZD
6095,2010.02.01 05:59,sell,3068,0.01,1.57140,,,EURAUD
6096,2010.02.01 06:00,buy,3069,0.01,0.88317,,,AUDUSD
6097,2010.02.01 06:02,sell,3070,0.01,1.80571,,,GBPAUD
6098,2010.02.01 06:05,sell,3071,0.01,1.57216,,,EURAUD
6099,2010.02.01 06:06,buy,3072,0.01,0.94466,,,AUDCAD
6100,2010.02.01 06:06,buy,3073,0.01,0.93593,,,AUDCHF
6101,2010.02.01 06:06,buy,3074,0.01,79.5790,,,AUDJPY
6102,2010.02.01 06:06,buy,3075,0.01,1.25878,,,AUDNZD
6103,2010.02.01 06:07,buy,3076,0.01,0.88254,,,AUDUSD
6104,2010.02.01 12:25,sell,3077,0.01,1.80216,,,GBPAUD
6105,2010.02.01 12:29,buy,3078,0.01,0.94349,,,AUDCAD
6106,2010.02.01 12:29,buy,3079,0.01,0.93303,,,AUDCHF
6107,2010.02.01 12:29,buy,3080,0.01,79.5440,,,AUDJPY
6108,2010.02.01 12:29,sell,3081,0.01,1.57796,,,EURAUD
6109,2010.02.01 12:30,buy,3082,0.01,1.25713,,,AUDNZD
6110,2010.02.01 12:30,buy,3083,0.01,0.88100,,,AUDUSD
6111,2010.02.02 01:25,close,3077,0.01,1.78988,12.76,20915.94,GBPAUD
6112,2010.02.02 01:25,close,3070,0.01,1.78988,16.41,20932.35,GBPAUD
6113,2010.02.02 01:25,close,3063,0.01,1.78988,16.60,20948.95,GBPAUD
6114,2010.02.02 01:25,close,3056,0.01,1.78988,13.18,20962.13,GBPAUD
6115,2010.02.02 01:25,close,3049,0.01,1.78988,14.02,20976.15,GBPAUD
6116,2010.02.02 01:25,close,3043,0.01,1.78988,21.62,20997.77,GBPAUD
6117,2010.02.02 01:25,close,3036,0.01,1.78988,18.99,21016.76,GBPAUD
6118,2010.02.02 01:25,close,3028,0.01,1.78988,11.39,21028.15,GBPAUD
6119,2010.02.02 01:29,close,3078,0.01,0.94520,1.74,21029.89,AUDCAD
6120,2010.02.02 01:29,close,3072,0.01,0.94520,0.58,21030.47,AUDCAD
6121,2010.02.02 01:29,close,3064,0.01,0.94520,0.67,21031.14,AUDCAD
6122,2010.02.02 01:29,close,3059,0.01,0.94520,-0.40,21030.74,AUDCAD
6123,2010.02.02 01:29,close,3052,0.01,0.94520,-1.11,21029.63,AUDCAD
6124,2010.02.02 01:29,close,3046,0.01,0.94520,-6.53,21023.10,AUDCAD
6125,2010.02.02 01:29,close,3038,0.01,0.94520,-8.88,21014.22,AUDCAD
6126,2010.02.02 01:29,close,3029,0.01,0.94520,-8.81,21005.41,AUDCAD
6127,2010.02.02 01:29,close,3079,0.01,0.94131,8.91,21014.32,AUDCHF
6128,2010.02.02 01:29,close,3073,0.01,0.94131,5.81,21020.13,AUDCHF
6129,2010.02.02 01:29,close,3065,0.01,0.94131,5.21,21025.34,AUDCHF
6130,2010.02.02 01:29,close,3060,0.01,0.94131,2.69,21028.03,AUDCHF
6131,2010.02.02 01:29,close,3050,0.01,0.94131,1.40,21029.43,AUDCHF
6132,2010.02.02 01:29,close,3044,0.01,0.94131,3.42,21032.85,AUDCHF
6133,2010.02.02 01:29,close,3040,0.01,0.94131,1.59,21034.44,AUDCHF
6134,2010.02.02 01:29,close,3032,0.01,0.94131,-0.90,21033.54,AUDCHF
6135,2010.02.02 01:29,close,3080,0.01,80.8630,13.37,21046.91,AUDJPY
6136,2010.02.02 01:29,close,3074,0.01,80.8630,13.02,21059.93,AUDJPY
6137,2010.02.02 01:29,close,3066,0.01,80.8630,12.36,21072.29,AUDJPY
6138,2010.02.02 01:29,close,3057,0.01,80.8630,9.08,21081.37,AUDJPY
6139,2010.02.02 01:29,close,3053,0.01,80.8630,6.07,21087.44,AUDJPY
6140,2010.02.02 01:29,close,3047,0.01,80.8630,6.33,21093.77,AUDJPY
6141,2010.02.02 01:29,close,3037,0.01,80.8630,5.86,21099.63,AUDJPY
6142,2010.02.02 01:29,close,3033,0.01,80.8630,3.36,21102.99,AUDJPY
6143,2010.02.02 01:29,close,3082,0.01,1.25670,-0.37,21102.62,AUDNZD
6144,2010.02.02 01:29,close,3075,0.01,1.25670,-1.77,21100.85,AUDNZD
6145,2010.02.02 01:29,close,3067,0.01,1.25670,-1.34,21099.51,AUDNZD
6146,2010.02.02 01:29,close,3061,0.01,1.25670,-2.07,21097.44,AUDNZD
6147,2010.02.02 01:29,close,3054,0.01,1.25670,-2.32,21095.12,AUDNZD
6148,2010.02.02 01:29,close,3045,0.01,1.25670,-7.17,21087.95,AUDNZD
6149,2010.02.02 01:29,close,3039,0.01,1.25670,-8.52,21079.43,AUDNZD
6150,2010.02.02 01:29,close,3030,0.01,1.25670,-9.99,21069.44,AUDNZD
6151,2010.02.02 01:29,close,3081,0.01,1.56239,16.14,21085.58,EURAUD
6152,2010.02.02 01:29,close,3071,0.01,1.56239,10.16,21095.74,EURAUD
6153,2010.02.02 01:29,close,3068,0.01,1.56239,9.38,21105.12,EURAUD
6154,2010.02.02 01:29,close,3058,0.01,1.56239,3.32,21108.44,EURAUD
6155,2010.02.02 01:29,close,3051,0.01,1.56239,0.40,21108.84,EURAUD
6156,2010.02.02 01:29,close,3042,0.01,1.56239,1.63,21110.47,EURAUD
6157,2010.02.02 01:29,close,3035,0.01,1.56239,-0.33,21110.14,EURAUD
6158,2010.02.02 01:29,close,3031,0.01,1.56239,-2.30,21107.84,EURAUD
6159,2010.02.02 01:30,close,3083,0.01,0.89091,9.97,21117.81,AUDUSD
6160,2010.02.02 01:30,close,3076,0.01,0.89091,8.43,21126.24,AUDUSD
6161,2010.02.02 01:30,close,3069,0.01,0.89091,7.81,21134.05,AUDUSD
6162,2010.02.02 01:30,close,3062,0.01,0.89091,5.83,21139.88,AUDUSD
6163,2010.02.02 01:30,close,3055,0.01,0.89091,3.78,21143.66,AUDUSD
6164,2010.02.02 01:30,close,3048,0.01,0.89091,-0.81,21142.85,AUDUSD
6165,2010.02.02 01:30,close,3041,0.01,0.89091,-2.04,21140.81,AUDUSD
6166,2010.02.02 01:30,close,3034,0.01,0.89091,-5.11,21135.70,AUDUSD
6167,2010.02.02 12:55,sell,3084,0.01,1.80641,,,GBPAUD
6168,2010.02.02 12:58,sell,3085,0.01,1.58047,,,EURAUD
6169,2010.02.02 12:59,buy,3086,0.01,0.93305,,,AUDCAD
6170,2010.02.02 12:59,buy,3087,0.01,0.93192,,,AUDCHF
6171,2010.02.02 12:59,buy,3088,0.01,79.9710,,,AUDJPY
6172,2010.02.02 12:59,buy,3089,0.01,1.24644,,,AUDNZD
6173,2010.02.02 13:00,buy,3090,0.01,0.88256,,,AUDUSD
6174,2010.02.03 09:25,close,3084,0.01,1.80458,1.98,21137.68,GBPAUD
6175,2010.02.03 09:28,close,3086,0.01,0.93840,5.35,21143.03,AUDCAD
6176,2010.02.03 09:28,close,3085,0.01,1.57327,7.52,21150.55,EURAUD
6177,2010.02.03 09:29,close,3087,0.01,0.93693,5.42,21155.97,AUDCHF
6178,2010.02.03 09:29,close,3088,0.01,80.1570,1.94,21157.91,AUDJPY
6179,2010.02.03 09:29,close,3089,0.01,1.24695,0.44,21158.35,AUDNZD
6180,2010.02.03 09:30,close,3090,0.01,0.88856,6.07,21164.42,AUDUSD
6181,2010.02.04 23:55,buy,3091,0.01,0.92423,,,AUDCHF
6182,2010.02.04 23:57,buy,3092,0.01,77.2550,,,AUDJPY
6183,2010.02.04 23:57,sell,3093,0.01,1.58360,,,EURAUD
6184,2010.02.04 23:58,buy,3094,0.01,0.92978,,,AUDCAD
6185,2010.02.05 00:00,buy,3095,0.01,1.25970,,,AUDNZD
6186,2010.02.05 00:00,buy,3096,0.01,0.86665,,,AUDUSD
6187,2010.02.05 00:00,sell,3097,0.01,1.81868,,,GBPAUD
6188,2010.02.09 06:56,close,3093,0.01,1.57663,7.47,21171.89,EURAUD
6189,2010.02.09 07:00,close,3091,0.01,0.93084,7.26,21179.15,AUDCHF
6190,2010.02.09 07:00,close,3095,0.01,1.26314,2.93,21182.08,AUDNZD
6191,2010.02.09 07:01,close,3094,0.01,0.92997,0.31,21182.39,AUDCAD
6192,2010.02.09 07:01,close,3092,0.01,77.6790,4.50,21186.89,AUDJPY
6193,2010.02.09 07:01,close,3096,0.01,0.86865,2.13,21189.02,AUDUSD
6194,2010.02.09 07:01,close,3097,0.01,1.79656,22.99,21212.01,GBPAUD
6195,2010.02.12 12:55,sell,3098,0.01,1.77119,,,GBPAUD
6196,2010.02.12 12:59,buy,3099,0.01,0.92941,,,AUDCAD
6197,2010.02.12 12:59,buy,3100,0.01,0.95282,,,AUDCHF
6198,2010.02.12 12:59,buy,3101,0.01,79.4020,,,AUDJPY
6199,2010.02.12 12:59,buy,3102,0.01,1.27207,,,AUDNZD
6200,2010.02.12 12:59,sell,3103,0.01,1.53753,,,EURAUD
6201,2010.02.12 13:00,buy,3104,0.01,0.88116,,,AUDUSD
6202,2010.02.12 16:37,sell,3105,0.01,1.77181,,,GBPAUD
6203,2010.02.12 16:42,buy,3106,0.01,0.93042,,,AUDCAD
6204,2010.02.12 16:42,buy,3107,0.01,0.94894,,,AUDCHF
6205,2010.02.12 16:42,buy,3108,0.01,79.3740,,,AUDJPY
6206,2010.02.12 16:42,buy,3109,0.01,1.27256,,,AUDNZD
6207,2010.02.12 16:42,buy,3110,0.01,0.88226,,,AUDUSD
6208,2010.02.12 16:42,sell,3111,0.01,1.54277,,,EURAUD
6209,2010.02.15 10:55,close,3105,0.01,1.76162,10.60,21222.61,GBPAUD
6210,2010.02.15 10:55,close,3098,0.01,1.76162,9.96,21232.57,GBPAUD
6211,2010.02.15 10:58,close,3111,0.01,1.53034,12.91,21245.48,EURAUD
6212,2010.02.15 10:58,close,3103,0.01,1.53034,7.51,21252.99,EURAUD
6213,2010.02.15 10:59,close,3106,0.01,0.93312,2.72,21255.71,AUDCAD
6214,2010.02.15 10:59,close,3099,0.01,0.93312,3.72,21259.43,AUDCAD
6215,2010.02.15 10:59,close,3107,0.01,0.95774,9.47,21268.90,AUDCHF
6216,2010.02.15 10:59,close,3100,0.01,0.95774,5.32,21274.22,AUDCHF
6217,2010.02.15 10:59,close,3108,0.01,80.0100,6.48,21280.70,AUDJPY
6218,2010.02.15 10:59,close,3101,0.01,80.0100,6.20,21286.90,AUDJPY
6219,2010.02.15 10:59,close,3109,0.01,1.27364,0.92,21287.82,AUDNZD
6220,2010.02.15 10:59,close,3102,0.01,1.27364,1.34,21289.16,AUDNZD
6221,2010.02.15 11:00,close,3110,0.01,0.88929,7.10,21296.26,AUDUSD
6222,2010.02.15 11:00,close,3104,0.01,0.88929,8.20,21304.46,AUDUSD
6223,2010.02.23 04:32,sell,3112,0.01,1.51307,,,EURAUD
6224,2010.02.23 04:34,buy,3113,0.01,0.96674,,,AUDCHF
6225,2010.02.23 04:35,buy,3114,0.01,81.8100,,,AUDJPY
6226,2010.02.23 04:37,buy,3115,0.01,0.93814,,,AUDCAD
6227,2010.02.23 04:37,buy,3116,0.01,1.28254,,,AUDNZD
6228,2010.02.23 04:37,buy,3117,0.01,0.89947,,,AUDUSD
6229,2010.02.23 04:37,sell,3118,0.01,1.72425,,,GBPAUD
6230,2010.02.23 11:55,close,3118,0.01,1.70882,15.90,21320.36,GBPAUD
6231,2010.02.23 11:59,close,3115,0.01,0.94153,3.36,21323.72,AUDCAD
6232,2010.02.23 11:59,close,3113,0.01,0.97184,5.45,21329.17,AUDCHF
6233,2010.02.23 11:59,close,3114,0.01,82.0130,2.04,21331.21,AUDJPY
6234,2010.02.23 11:59,close,3116,0.01,1.28496,2.07,21333.28,AUDNZD
6235,2010.02.23 11:59,close,3112,0.01,1.50805,5.18,21338.46,EURAUD
6236,2010.02.23 12:00,close,3117,0.01,0.90155,2.08,21340.54,AUDUSD
6237,2010.02.23 22:25,sell,3119,0.01,1.73165,,,GBPAUD
6238,2010.02.23 22:28,buy,3120,0.01,0.94046,,,AUDCAD
6239,2010.02.23 22:28,sell,3121,0.01,1.51692,,,EURAUD
6240,2010.02.23 22:29,buy,3122,0.01,0.96499,,,AUDCHF
6241,2010.02.23 22:29,buy,3123,0.01,80.3410,,,AUDJPY
6242,2010.02.23 22:29,buy,3124,0.01,1.28609,,,AUDNZD
6243,2010.02.23 22:30,buy,3125,0.01,0.89058,,,AUDUSD
6244,2010.02.24 11:55,sell,3126,0.01,1.52489,,,EURAUD
6245,2010.02.24 11:59,buy,3127,0.01,0.93878,,,AUDCAD
6246,2010.02.24 11:59,sell,3128,0.01,1.73821,,,GBPAUD
6247,2010.02.24 12:00,buy,3129,0.01,0.96049,,,AUDCHF
6248,2010.02.24 12:00,buy,3130,0.01,80.1410,,,AUDJPY
6249,2010.02.24 12:00,buy,3131,0.01,1.28886,,,AUDNZD
6250,2010.02.24 12:00,buy,3132,0.01,0.88916,,,AUDUSD
6251,2010.02.25 18:55,sell,3133,0.01,1.72294,,,GBPAUD
6252,2010.02.25 18:56,buy,3134,0.01,0.95775,,,AUDCHF
6253,2010.02.25 18:56,sell,3135,0.01,1.52920,,,EURAUD
6254,2010.02.25 18:57,buy,3136,0.01,0.94151,,,AUDCAD
6255,2010.02.25 18:59,buy,3137,0.01,78.6090,,,AUDJPY
6256,2010.02.25 18:59,buy,3138,0.01,1.28402,,,AUDNZD
6257,2010.02.25 19:00,buy,3139,0.01,0.88411,,,AUDUSD
6258,2010.02.25 19:11,sell,3140,0.01,1.72332,,,GBPAUD
6259,2010.02.25 19:12,sell,3141,0.01,1.52955,,,EURAUD
6260,2010.02.25 19:14,buy,3142,0.01,0.95701,,,AUDCHF
6261,2010.02.25 19:15,buy,3143,0.01,0.94142,,,AUDCAD
6262,2010.02.25 19:16,buy,3144,0.01,78.6030,,,AUDJPY
6263,2010.02.25 19:16,buy,3145,0.01,1.28411,,,AUDNZD
6264,2010.02.25 19:16,buy,3146,0.01,0.88359,,,AUDUSD
6265,2010.02.26 15:55,close,3140,0.01,1.70192,22.15,21362.69,GBPAUD
6266,2010.02.26 15:55,close,3133,0.01,1.70192,21.76,21384.45,GBPAUD
6267,2010.02.26 15:55,close,3128,0.01,1.70192,37.79,21422.24,GBPAUD
6268,2010.02.26 15:55,close,3119,0.01,1.70192,31.12,21453.36,GBPAUD
6269,2010.02.26 15:59,close,3143,0.01,0.94245,1.06,21454.42,AUDCAD
6270,2010.02.26 15:59,close,3136,0.01,0.94245,0.97,21455.39,AUDCAD
6271,2010.02.26 15:59,close,3127,0.01,0.94245,3.81,21459.20,AUDCAD
6272,2010.02.26 15:59,close,3120,0.01,0.94245,2.18,21461.38,AUDCAD
6273,2010.02.26 15:59,close,3142,0.01,0.96032,3.60,21464.98,AUDCHF
6274,2010.02.26 15:59,close,3134,0.01,0.96032,2.80,21467.78,AUDCHF
6275,2010.02.26 15:59,close,3129,0.01,0.96032,0.08,21467.86,AUDCHF
6276,2010.02.26 15:59,close,3122,0.01,0.96032,-4.68,21463.18,AUDCHF
6277,2010.02.26 15:59,close,3144,0.01,79.4270,8.38,21471.56,AUDJPY
6278,2010.02.26 15:59,close,3137,0.01,79.4270,8.32,21479.88,AUDJPY
6279,2010.02.26 15:59,close,3130,0.01,79.4270,-6.91,21472.97,AUDJPY
6280,2010.02.26 15:59,close,3123,0.01,79.4270,-8.86,21464.11,AUDJPY
6281,2010.02.26 15:59,close,3145,0.01,1.28160,-2.14,21461.97,AUDNZD
6282,2010.02.26 15:59,close,3138,0.01,1.28160,-2.07,21459.90,AUDNZD
6283,2010.02.26 15:59,close,3131,0.01,1.28160,-6.21,21453.69,AUDNZD
6284,2010.02.26 15:59,close,3124,0.01,1.28160,-3.84,21449.85,AUDNZD
6285,2010.02.26 15:59,close,3141,0.01,1.52397,5.85,21455.70,EURAUD
6286,2010.02.26 15:59,close,3135,0.01,1.52397,5.49,21461.19,EURAUD
6287,2010.02.26 15:59,close,3126,0.01,1.52397,1.34,21462.53,EURAUD
6288,2010.02.26 15:59,close,3121,0.01,1.52397,-6.78,21455.75,EURAUD
6289,2010.02.26 16:00,close,3146,0.01,0.89142,7.90,21463.65,AUDUSD
6290,2010.02.26 16:00,close,3139,0.01,0.89142,7.38,21471.03,AUDUSD
6291,2010.02.26 16:00,close,3132,0.01,0.89142,2.52,21473.55,AUDUSD
6292,2010.02.26 16:00,close,3125,0.01,0.89142,1.17,21474.72,AUDUSD
6293,2010.03.03 04:25,sell,3147,0.01,1.66490,,,GBPAUD
6294,2010.03.03 04:26,sell,3148,0.01,1.50833,,,EURAUD
6295,2010.03.03 04:29,buy,3149,0.01,0.93514,,,AUDCAD
6296,2010.03.03 04:29,buy,3150,0.01,0.97012,,,AUDCHF
6297,2010.03.03 04:29,buy,3151,0.01,80.1600,,,AUDJPY
6298,2010.03.03 04:29,buy,3152,0.01,1.29565,,,AUDNZD
6299,2010.03.03 04:30,buy,3153,0.01,0.90370,,,AUDUSD
6300,2010.03.04 09:25,sell,3154,0.01,1.51663,,,EURAUD
6301,2010.03.04 09:29,buy,3155,0.01,79.6190,,,AUDJPY
6302,2010.03.04 09:29,buy,3156,0.01,1.30639,,,AUDNZD
6303,2010.03.04 09:30,buy,3157,0.01,0.92905,,,AUDCAD
6304,2010.03.04 09:30,buy,3158,0.01,0.96514,,,AUDCHF
6305,2010.03.04 09:30,buy,3159,0.01,0.90036,,,AUDUSD
6306,2010.03.04 09:30,sell,3160,0.01,1.66980,,,GBPAUD
6307,2010.03.04 09:31,sell,3161,0.01,1.51633,,,EURAUD
6308,2010.03.04 09:35,buy,3162,0.01,0.92884,,,AUDCAD
6309,2010.03.04 09:35,buy,3163,0.01,0.96500,,,AUDCHF
6310,2010.03.04 09:35,sell,3164,0.01,1.67014,,,GBPAUD
6311,2010.03.04 09:36,buy,3165,0.01,79.5550,,,AUDJPY
6312,2010.03.04 09:36,buy,3166,0.01,1.30632,,,AUDNZD
6313,2010.03.04 09:36,buy,3167,0.01,0.90004,,,AUDUSD
6314,2010.03.05 09:19,close,3163,0.01,0.97046,5.89,21480.61,AUDCHF
6315,2010.03.05 09:19,close,3158,0.01,0.97046,5.74,21486.35,AUDCHF
6316,2010.03.05 09:19,close,3150,0.01,0.97046,0.62,21486.97,AUDCHF
6317,2010.03.05 09:22,close,3161,0.01,1.50770,9.00,21495.97,EURAUD
6318,2010.03.05 09:22,close,3154,0.01,1.50770,9.31,21505.28,EURAUD
6319,2010.03.05 09:22,close,3148,0.01,1.50770,1.04,21506.32,EURAUD
6320,2010.03.05 09:23,close,3164,0.01,1.66846,1.83,21508.15,GBPAUD
6321,2010.03.05 09:23,close,3160,0.01,1.66846,1.48,21509.63,GBPAUD
6322,2010.03.05 09:23,close,3147,0.01,1.66846,-3.27,21506.36,GBPAUD
6323,2010.03.05 09:24,close,3162,0.01,0.93046,1.65,21508.01,AUDCAD
6324,2010.03.05 09:24,close,3157,0.01,0.93046,1.44,21509.45,AUDCAD
6325,2010.03.05 09:24,close,3149,0.01,0.93046,-4.47,21504.98,AUDCAD
6326,2010.03.05 09:24,close,3165,0.01,80.4810,9.41,21514.39,AUDJPY
6327,2010.03.05 09:24,close,3155,0.01,80.4810,8.76,21523.15,AUDJPY
6328,2010.03.05 09:24,close,3151,0.01,80.4810,3.53,21526.68,AUDJPY
6329,2010.03.05 09:24,close,3166,0.01,1.30691,0.51,21527.19,AUDNZD
6330,2010.03.05 09:24,close,3156,0.01,1.30691,0.45,21527.64,AUDNZD
6331,2010.03.05 09:24,close,3152,0.01,1.30691,9.60,21537.24,AUDNZD
6332,2010.03.05 09:24,close,3167,0.01,0.90072,0.75,21537.99,AUDUSD
6333,2010.03.05 09:24,close,3159,0.01,0.90072,0.42,21538.41,AUDUSD
6334,2010.03.05 09:24,close,3153,0.01,0.90072,-2.72,21535.69,AUDUSD
6335,2010.03.10 18:55,sell,3168,0.01,1.63427,,,GBPAUD
6336,2010.03.10 18:59,buy,3169,0.01,0.93864,,,AUDCAD
6337,2010.03.10 18:59,buy,3170,0.01,0.97998,,,AUDCHF
6338,2010.03.10 18:59,buy,3171,0.01,82.8360,,,AUDJPY
6339,2010.03.10 18:59,buy,3172,0.01,1.29537,,,AUDNZD
6340,2010.03.10 18:59,sell,3173,0.01,1.49181,,,EURAUD
6341,2010.03.10 19:00,buy,3174,0.01,0.91484,,,AUDUSD
6342,2010.03.11 09:55,close,3168,0.01,1.63564,-1.11,21534.58,GBPAUD
6343,2010.03.11 09:59,close,3169,0.01,0.93954,1.03,21535.61,AUDCAD
6344,2010.03.11 09:59,close,3170,0.01,0.98031,0.54,21536.15,AUDCHF
6345,2010.03.11 09:59,close,3171,0.01,82.8770,0.64,21536.79,AUDJPY
6346,2010.03.11 09:59,close,3172,0.01,1.30847,11.17,21547.96,AUDNZD
6347,2010.03.11 10:00,close,3174,0.01,0.91614,1.50,21549.46,AUDUSD
6348,2010.03.11 10:00,close,3173,0.01,1.49045,1.69,21551.15,EURAUD
6349,2010.03.12 19:25,sell,3175,0.01,1.65655,,,GBPAUD
6350,2010.03.12 19:29,buy,3176,0.01,0.93280,,,AUDCAD
6351,2010.03.12 19:29,buy,3177,0.01,0.97105,,,AUDCHF
6352,2010.03.12 19:29,buy,3178,0.01,82.9750,,,AUDJPY
6353,2010.03.12 19:29,buy,3179,0.01,1.30661,,,AUDNZD
6354,2010.03.12 19:29,sell,3180,0.01,1.50114,,,EURAUD
6355,2010.03.12 19:30,buy,3181,0.01,0.91654,,,AUDUSD
6356,2010.03.15 00:00,buy,3182,0.01,0.93301,,,AUDCAD
6357,2010.03.15 00:00,buy,3183,0.01,0.97130,,,AUDCHF
6358,2010.03.15 00:00,buy,3184,0.01,83.0990,,,AUDJPY
6359,2010.03.15 00:00,buy,3185,0.01,1.30412,,,AUDNZD
6360,2010.03.15 00:00,buy,3186,0.01,0.91717,,,AUDUSD
6361,2010.03.15 00:00,sell,3187,0.01,1.49998,,,EURAUD
6362,2010.03.15 00:00,sell,3188,0.01,1.65380,,,GBPAUD
6363,2010.03.15 03:27,buy,3189,0.01,82.9330,,,AUDJPY
6364,2010.03.15 03:27,sell,3190,0.01,1.50285,,,EURAUD
6365,2010.03.15 03:29,buy,3191,0.01,1.30179,,,AUDNZD
6366,2010.03.15 03:30,sell,3192,0.01,1.65826,,,GBPAUD
6367,2010.03.15 03:31,buy,3193,0.01,0.96923,,,AUDCHF
6368,2010.03.15 03:32,buy,3194,0.01,0.93065,,,AUDCAD
6369,2010.03.15 03:32,buy,3195,0.01,0.91476,,,AUDUSD
6370,2010.03.15 22:25,close,3189,0.01,82.7530,-1.81,21549.34,AUDJPY
6371,2010.03.15 22:25,close,3184,0.01,82.7530,-3.49,21545.85,AUDJPY
6372,2010.03.15 22:25,close,3178,0.01,82.7530,-2.17,21543.68,AUDJPY
6373,2010.03.15 22:25,close,3190,0.01,1.49503,8.06,21551.74,EURAUD
6374,2010.03.15 22:25,close,3187,0.01,1.49503,5.10,21556.84,EURAUD
6375,2010.03.15 22:25,close,3180,0.01,1.49503,6.39,21563.23,EURAUD
6376,2010.03.15 22:26,close,3194,0.01,0.93140,0.74,21563.97,AUDCAD
6377,2010.03.15 22:26,close,3182,0.01,0.93140,-1.60,21562.37,AUDCAD
6378,2010.03.15 22:26,close,3176,0.01,0.93140,-1.35,21561.02,AUDCAD
6379,2010.03.15 22:26,close,3193,0.01,0.97075,1.62,21562.64,AUDCHF
6380,2010.03.15 22:26,close,3183,0.01,0.97075,-0.59,21562.05,AUDCHF
6381,2010.03.15 22:26,close,3177,0.01,0.97075,-0.26,21561.79,AUDCHF
6382,2010.03.15 22:26,close,3191,0.01,1.30179,0.00,21561.79,AUDNZD
6383,2010.03.15 22:26,close,3185,0.01,1.30179,-1.98,21559.81,AUDNZD
6384,2010.03.15 22:26,close,3179,0.01,1.30179,-4.11,21555.70,AUDNZD
6385,2010.03.15 22:26,close,3192,0.01,1.64550,13.15,21568.85,GBPAUD
6386,2010.03.15 22:26,close,3188,0.01,1.64550,8.56,21577.41,GBPAUD
6387,2010.03.15 22:26,close,3175,0.01,1.64550,11.49,21588.90,GBPAUD
6388,2010.03.15 22:30,close,3195,0.01,0.91440,-0.36,21588.54,AUDUSD
6389,2010.03.15 22:30,close,3186,0.01,0.91440,-2.77,21585.77,AUDUSD
6390,2010.03.15 22:30,close,3181,0.01,0.91440,-2.08,21583.69,AUDUSD
6391,2010.03.16 17:55,sell,3196,0.01,1.65841,,,GBPAUD
6392,2010.03.16 17:59,buy,3197,0.01,0.92928,,,AUDCAD
6393,2010.03.16 17:59,buy,3198,0.01,0.96647,,,AUDCHF
6394,2010.03.16 17:59,buy,3199,0.01,82.8360,,,AUDJPY
6395,2010.03.16 17:59,buy,3200,0.01,1.29408,,,AUDNZD
6396,2010.03.16 17:59,sell,3201,0.01,1.50251,,,EURAUD
6397,2010.03.16 18:00,buy,3202,0.01,0.91543,,,AUDUSD
6398,2010.03.17 12:25,close,3196,0.01,1.66315,-4.78,21578.91,GBPAUD
6399,2010.03.17 12:29,close,3197,0.01,0.93358,4.30,21583.21,AUDCAD
6400,2010.03.17 12:29,close,3198,0.01,0.97084,4.73,21587.94,AUDCHF
6401,2010.03.17 12:29,close,3199,0.01,83.4670,6.44,21594.38,AUDJPY
6402,2010.03.17 12:29,close,3200,0.01,1.29052,-3.03,21591.35,AUDNZD
6403,2010.03.17 12:29,close,3201,0.01,1.49419,8.68,21600.03,EURAUD
6404,2010.03.17 12:30,close,3202,0.01,0.92275,7.39,21607.42,AUDUSD
6405,2010.03.22 08:55,sell,3203,0.01,1.63889,,,GBPAUD
6406,2010.03.22 08:59,buy,3204,0.01,0.96915,,,AUDCHF
6407,2010.03.22 08:59,buy,3205,0.01,1.29174,,,AUDNZD
6408,2010.03.22 08:59,sell,3206,0.01,1.48057,,,EURAUD
6409,2010.03.22 09:00,buy,3207,0.01,0.92801,,,AUDCAD
6410,2010.03.22 09:00,buy,3208,0.01,82.6640,,,AUDJPY
6411,2010.03.22 09:00,buy,3209,0.01,0.91276,,,AUDUSD
6412,2010.03.22 10:39,buy,3210,0.01,0.96678,,,AUDCHF
6413,2010.03.22 10:42,sell,3211,0.01,1.64079,,,GBPAUD
6414,2010.03.22 10:44,buy,3212,0.01,0.92696,,,AUDCAD
6415,2010.03.22 10:44,buy,3213,0.01,82.5760,,,AUDJPY
6416,2010.03.22 10:44,buy,3214,0.01,1.29269,,,AUDNZD
6417,2010.03.22 10:44,buy,3215,0.01,0.91234,,,AUDUSD
6418,2010.03.22 10:44,sell,3216,0.01,1.48239,,,EURAUD
6419,2010.03.22 18:55,close,3211,0.01,1.64459,-3.92,21603.50,GBPAUD
6420,2010.03.22 18:55,close,3203,0.01,1.64459,-5.88,21597.62,GBPAUD
6421,2010.03.22 18:56,close,3216,0.01,1.47817,4.34,21601.96,EURAUD
6422,2010.03.22 18:56,close,3206,0.01,1.47817,2.47,21604.43,EURAUD
6423,2010.03.22 18:57,close,3210,0.01,0.97002,3.46,21607.89,AUDCHF
6424,2010.03.22 18:57,close,3204,0.01,0.97002,0.93,21608.82,AUDCHF
6425,2010.03.22 18:59,close,3212,0.01,0.93556,8.53,21617.35,AUDCAD
6426,2010.03.22 18:59,close,3207,0.01,0.93556,7.49,21624.84,AUDCAD
6427,2010.03.22 18:59,close,3213,0.01,82.5290,-0.47,21624.37,AUDJPY
6428,2010.03.22 18:59,close,3208,0.01,82.5290,-1.36,21623.01,AUDJPY
6429,2010.03.22 18:59,close,3214,0.01,1.29907,5.44,21628.45,AUDNZD
6430,2010.03.22 18:59,close,3205,0.01,1.29907,6.25,21634.70,AUDNZD
6431,2010.03.22 19:00,close,3215,0.01,0.91703,4.69,21639.39,AUDUSD
6432,2010.03.22 19:00,close,3209,0.01,0.91703,4.27,21643.66,AUDUSD
6433,2010.03.26 03:14,sell,3217,0.01,1.46690,,,EURAUD
6434,2010.03.26 03:18,buy,3218,0.01,0.97325,,,AUDCHF
6435,2010.03.26 03:18,buy,3219,0.01,83.9500,,,AUDJPY
6436,2010.03.26 03:18,buy,3220,0.01,1.28767,,,AUDNZD
6437,2010.03.26 03:18,sell,3221,0.01,1.63688,,,GBPAUD
6438,2010.03.26 03:19,buy,3222,0.01,0.92909,,,AUDCAD
6439,2010.03.26 03:19,buy,3223,0.01,0.90817,,,AUDUSD
6440,2010.03.26 12:25,sell,3224,0.01,1.63766,,,GBPAUD
6441,2010.03.26 12:30,buy,3225,0.01,0.93078,,,AUDCAD
6442,2010.03.26 12:30,buy,3226,0.01,0.96879,,,AUDCHF
6443,2010.03.26 12:30,buy,3227,0.01,83.9680,,,AUDJPY
6444,2010.03.26 12:30,buy,3228,0.01,1.28470,,,AUDNZD
6445,2010.03.26 12:30,buy,3229,0.01,0.90736,,,AUDUSD
6446,2010.03.26 12:30,sell,3230,0.01,1.47652,,,EURAUD
6447,2010.03.26 20:56,sell,3231,0.01,1.48496,,,EURAUD
6448,2010.03.26 20:56,sell,3232,0.01,1.48492,,,EURAUD
6449,2010.03.26 20:56,sell,3233,0.01,1.48488,,,EURAUD
6450,2010.03.26 20:59,buy,3234,0.01,0.96261,,,AUDCHF
6451,2010.03.26 20:59,buy,3235,0.01,0.96264,,,AUDCHF
6452,2010.03.26 20:59,buy,3236,0.01,0.96269,,,AUDCHF
6453,2010.03.26 20:59,sell,3237,0.01,1.64905,,,GBPAUD
6454,2010.03.26 20:59,sell,3238,0.01,1.64911,,,GBPAUD
6455,2010.03.26 20:59,sell,3239,0.01,1.64908,,,GBPAUD
6456,2010.03.26 21:00,buy,3240,0.01,0.92773,,,AUDCAD
6457,2010.03.26 21:00,buy,3241,0.01,0.92775,,,AUDCAD
6458,2010.03.26 21:00,buy,3242,0.01,0.92778,,,AUDCAD
6459,2010.03.26 21:01,buy,3243,0.01,83.5930,,,AUDJPY
6460,2010.03.26 21:01,buy,3244,0.01,83.5980,,,AUDJPY
6461,2010.03.26 21:01,buy,3245,0.01,83.5950,,,AUDJPY
6462,2010.03.26 21:01,buy,3246,0.01,1.28351,,,AUDNZD
6463,2010.03.26 21:01,buy,3247,0.01,1.28347,,,AUDNZD
6464,2010.03.26 21:01,buy,3248,0.01,1.28334,,,AUDNZD
6465,2010.03.26 21:01,buy,3249,0.01,0.90394,,,AUDUSD
6466,2010.03.26 21:01,buy,3250,0.01,0.90393,,,AUDUSD
6467,2010.03.26 21:01,buy,3251,0.01,0.90395,,,AUDUSD
6468,2010.03.29 00:00,close,3251,0.01,0.90406,0.17,21643.83,AUDUSD
6469,2010.03.29 00:00,close,3250,0.01,0.90406,0.20,21644.03,AUDUSD
6470,2010.03.29 00:00,close,3249,0.01,0.90406,0.19,21644.22,AUDUSD
6471,2010.03.29 00:00,close,3229,0.01,0.90406,-3.23,21640.99,AUDUSD
6472,2010.03.29 00:00,close,3223,0.01,0.90406,-4.04,21636.95,AUDUSD
6473,2010.03.29 03:38,close,3236,0.01,0.96690,4.56,21641.51,AUDCHF
6474,2010.03.29 03:38,close,3235,0.01,0.96690,4.62,21646.13,AUDCHF
6475,2010.03.29 03:38,close,3234,0.01,0.96690,4.65,21650.78,AUDCHF
6476,2010.03.29 03:38,close,3226,0.01,0.96690,-1.96,21648.82,AUDCHF
6477,2010.03.29 03:38,close,3218,0.01,0.96690,-6.72,21642.10,AUDCHF
6478,2010.03.29 03:40,close,3245,0.01,83.8900,3.04,21645.14,AUDJPY
6479,2010.03.29 03:40,close,3244,0.01,83.8900,3.01,21648.15,AUDJPY
6480,2010.03.29 03:40,close,3243,0.01,83.8900,3.06,21651.21,AUDJPY
6481,2010.03.29 03:40,close,3227,0.01,83.8900,-0.72,21650.49,AUDJPY
6482,2010.03.29 03:40,close,3219,0.01,83.8900,-0.54,21649.95,AUDJPY
6483,2010.03.29 03:40,close,3239,0.01,1.64501,4.29,21654.24,GBPAUD
6484,2010.03.29 03:40,close,3238,0.01,1.64501,4.32,21658.56,GBPAUD
6485,2010.03.29 03:40,close,3237,0.01,1.64501,4.26,21662.82,GBPAUD
6486,2010.03.29 03:40,close,3224,0.01,1.64501,-7.48,21655.34,GBPAUD
6487,2010.03.29 03:40,close,3221,0.01,1.64501,-8.28,21647.06,GBPAUD
6488,2010.03.29 04:57,close,3242,0.01,0.92992,2.16,21649.22,AUDCAD
6489,2010.03.29 04:57,close,3241,0.01,0.92992,2.19,21651.41,AUDCAD
6490,2010.03.29 04:57,close,3240,0.01,0.92992,2.21,21653.62,AUDCAD
6491,2010.03.29 04:57,close,3225,0.01,0.92992,-0.82,21652.80,AUDCAD
6492,2010.03.29 04:57,close,3222,0.01,0.92992,0.86,21653.66,AUDCAD
6493,2010.03.29 04:57,close,3248,0.01,1.28359,0.21,21653.87,AUDNZD
6494,2010.03.29 04:57,close,3247,0.01,1.28359,0.10,21653.97,AUDNZD
6495,2010.03.29 04:57,close,3246,0.01,1.28359,0.07,21654.04,AUDNZD
6496,2010.03.29 04:57,close,3228,0.01,1.28359,-0.95,21653.09,AUDNZD
6497,2010.03.29 04:57,close,3220,0.01,1.28359,-3.48,21649.61,AUDNZD
6498,2010.03.29 04:58,close,3233,0.01,1.48019,4.93,21654.54,EURAUD
6499,2010.03.29 04:58,close,3232,0.01,1.48019,4.97,21659.51,EURAUD
6500,2010.03.29 04:58,close,3231,0.01,1.48019,5.01,21664.52,EURAUD
6501,2010.03.29 04:58,close,3230,0.01,1.48019,-3.68,21660.84,EURAUD
6502,2010.03.29 04:58,close,3217,0.01,1.48019,-13.60,21647.24,EURAUD
6503,2010.03.31 03:55,buy,3252,0.01,85.4470,,,AUDJPY
6504,2010.03.31 03:59,buy,3253,0.01,0.97764,,,AUDCHF
6505,2010.03.31 03:59,buy,3254,0.01,1.28948,,,AUDNZD
6506,2010.03.31 03:59,sell,3255,0.01,1.46316,,,EURAUD
6507,2010.03.31 03:59,sell,3256,0.01,1.64459,,,GBPAUD
6508,2010.03.31 04:00,buy,3257,0.01,0.93251,,,AUDCAD
6509,2010.03.31 04:00,buy,3258,0.01,0.91585,,,AUDUSD
6510,2010.03.31 05:56,buy,3259,0.01,85.5360,,,AUDJPY
6511,2010.03.31 06:00,buy,3260,0.01,0.93170,,,AUDCAD
6512,2010.03.31 06:00,buy,3261,0.01,0.97643,,,AUDCHF
6513,2010.03.31 06:00,buy,3262,0.01,1.28891,,,AUDNZD
6514,2010.03.31 06:00,sell,3263,0.01,1.46496,,,EURAUD
6515,2010.03.31 06:00,sell,3264,0.01,1.64770,,,GBPAUD
6516,2010.03.31 06:01,buy,3265,0.01,0.91441,,,AUDUSD
6517,2010.03.31 08:48,sell,3266,0.01,1.64758,,,GBPAUD
6518,2010.03.31 08:51,sell,3267,0.01,1.46728,,,EURAUD
6519,2010.03.31 08:53,buy,3268,0.01,0.93056,,,AUDCAD
6520,2010.03.31 08:53,buy,3269,0.01,0.97525,,,AUDCHF
6521,2010.03.31 08:53,buy,3270,0.01,85.1980,,,AUDJPY
6522,2010.03.31 08:53,buy,3271,0.01,1.28807,,,AUDNZD
6523,2010.03.31 08:53,buy,3272,0.01,0.91425,,,AUDUSD
6524,2010.03.31 15:25,sell,3273,0.01,1.65270,,,GBPAUD
6525,2010.03.31 15:29,buy,3274,0.01,0.96907,,,AUDCHF
6526,2010.03.31 15:29,buy,3275,0.01,85.3100,,,AUDJPY
6527,2010.03.31 15:29,buy,3276,0.01,1.29361,,,AUDNZD
6528,2010.03.31 15:29,sell,3277,0.01,1.47340,,,EURAUD
6529,2010.03.31 15:30,buy,3278,0.01,0.93061,,,AUDCAD
6530,2010.03.31 15:30,buy,3279,0.01,0.91672,,,AUDUSD
6531,2010.04.02 13:25,close,3277,0.01,1.47399,-0.22,21647.02,EURAUD
6532,2010.04.02 13:25,close,3267,0.01,1.47399,-6.52,21640.50,EURAUD
6533,2010.04.02 13:25,close,3263,0.01,1.47399,-8.92,21631.58,EURAUD
6534,2010.04.02 13:25,close,3255,0.01,1.47399,-10.77,21620.81,EURAUD
6535,2010.04.02 13:29,close,3274,0.01,0.97166,3.03,21623.84,AUDCHF
6536,2010.04.02 13:29,close,3269,0.01,0.97166,-3.57,21620.27,AUDCHF
6537,2010.04.02 13:29,close,3261,0.01,0.97166,-4.83,21615.44,AUDCHF
6538,2010.04.02 13:29,close,3253,0.01,0.97166,-6.13,21609.31,AUDCHF
6539,2010.04.02 13:29,close,3275,0.01,86.4060,11.34,21620.65,AUDJPY
6540,2010.04.02 13:29,close,3270,0.01,86.4060,12.47,21633.12,AUDJPY
6541,2010.04.02 13:29,close,3259,0.01,86.4060,9.06,21642.18,AUDJPY
6542,2010.04.02 13:29,close,3252,0.01,86.4060,9.96,21652.14,AUDJPY
6543,2010.04.02 13:29,close,3276,0.01,1.30059,5.95,21658.09,AUDNZD
6544,2010.04.02 13:29,close,3271,0.01,1.30059,10.67,21668.76,AUDNZD
6545,2010.04.02 13:29,close,3262,0.01,1.30059,9.96,21678.72,AUDNZD
6546,2010.04.02 13:29,close,3254,0.01,1.30059,9.47,21688.19,AUDNZD
6547,2010.04.02 13:30,close,3279,0.01,0.91937,2.91,21691.10,AUDUSD
6548,2010.04.02 13:30,close,3272,0.01,0.91937,5.38,21696.48,AUDUSD
6549,2010.04.02 13:30,close,3265,0.01,0.91937,5.22,21701.70,AUDUSD
6550,2010.04.02 13:30,close,3258,0.01,0.91937,3.78,21705.48,AUDUSD
6551,2010.04.06 02:55,sell,3280,0.01,1.46402,,,EURAUD
6552,2010.04.06 02:55,sell,3281,0.01,1.46401,,,EURAUD
6553,2010.04.06 02:55,sell,3282,0.01,1.46400,,,EURAUD
6554,2010.04.06 02:55,sell,3283,0.01,1.46399,,,EURAUD
6555,2010.04.06 02:57,buy,3284,0.01,86.5040,,,AUDJPY
6556,2010.04.06 02:57,buy,3285,0.01,86.4930,,,AUDJPY
6557,2010.04.06 02:58,buy,3286,0.01,86.4910,,,AUDJPY
6558,2010.04.06 02:58,buy,3287,0.01,86.4890,,,AUDJPY
6559,2010.04.06 02:58,sell,3288,0.01,1.46384,,,EURAUD
6560,2010.04.06 02:59,buy,3289,0.01,0.97808,,,AUDCHF
6561,2010.04.06 03:00,buy,3290,0.01,0.97809,,,AUDCHF
6562,2010.04.06 03:00,buy,3291,0.01,0.97808,,,AUDCHF
6563,2010.04.06 03:00,buy,3292,0.01,0.97807,,,AUDCHF
6564,2010.04.06 03:00,buy,3293,0.01,86.4000,,,AUDJPY
6565,2010.04.06 03:00,buy,3294,0.01,1.30590,,,AUDNZD
6566,2010.04.06 03:00,buy,3295,0.01,1.30591,,,AUDNZD
6567,2010.04.06 03:00,buy,3296,0.01,1.30592,,,AUDNZD
6568,2010.04.06 03:00,buy,3297,0.01,1.30593,,,AUDNZD
6569,2010.04.06 03:00,buy,3298,0.03,0.91811,,,AUDUSD
6570,2010.04.06 03:00,buy,3299,0.01,0.91810,,,AUDUSD
6571,2010.04.06 03:03,buy,3300,0.01,0.92150,,,AUDCAD
6572,2010.04.06 03:03,buy,3301,0.01,0.97795,,,AUDCHF
6573,2010.04.06 03:03,buy,3302,0.01,1.30612,,,AUDNZD
6574,2010.04.06 03:03,buy,3303,0.01,0.91787,,,AUDUSD
6575,2010.04.06 03:03,sell,3304,0.01,1.66102,,,GBPAUD
6576,2010.04.06 16:25,close,3304,0.01,1.64395,17.59,21723.07,GBPAUD
6577,2010.04.06 16:25,close,3273,0.01,1.64395,9.60,21732.67,GBPAUD
6578,2010.04.06 16:25,close,3266,0.01,1.64395,4.33,21737.00,GBPAUD
6579,2010.04.06 16:25,close,3264,0.01,1.64395,4.45,21741.45,GBPAUD
6580,2010.04.06 16:25,close,3256,0.01,1.64395,1.25,21742.70,GBPAUD
6581,2010.04.06 16:29,close,3300,0.01,0.92312,1.61,21744.31,AUDCAD
6582,2010.04.06 16:29,close,3278,0.01,0.92312,-7.17,21737.14,AUDCAD
6583,2010.04.06 16:29,close,3268,0.01,0.92312,-7.12,21730.02,AUDCAD
6584,2010.04.06 16:29,close,3260,0.01,0.92312,-8.25,21721.77,AUDCAD
6585,2010.04.06 16:29,close,3257,0.01,0.92312,-9.05,21712.72,AUDCAD
6586,2010.04.06 16:29,close,3301,0.01,0.98799,10.73,21723.45,AUDCHF
6587,2010.04.06 16:29,close,3292,0.01,0.98799,10.60,21734.05,AUDCHF
6588,2010.04.06 16:29,close,3291,0.01,0.98799,10.59,21744.64,AUDCHF
6589,2010.04.06 16:29,close,3290,0.01,0.98799,10.58,21755.22,AUDCHF
6590,2010.04.06 16:29,close,3289,0.01,0.98799,10.59,21765.81,AUDCHF
6591,2010.04.06 16:30,close,3293,0.01,86.7370,3.40,21769.21,AUDJPY
6592,2010.04.06 16:30,close,3287,0.01,86.7370,2.50,21771.71,AUDJPY
6593,2010.04.06 16:30,close,3286,0.01,86.7370,2.48,21774.19,AUDJPY
6594,2010.04.06 16:30,close,3285,0.01,86.7370,2.46,21776.65,AUDJPY
6595,2010.04.06 16:30,close,3284,0.01,86.7370,2.35,21779.00,AUDJPY
6596,2010.04.06 16:30,close,3302,0.01,1.32088,12.60,21791.60,AUDNZD
6597,2010.04.06 16:30,close,3297,0.01,1.32088,12.76,21804.36,AUDNZD
6598,2010.04.06 16:30,close,3296,0.01,1.32088,12.77,21817.13,AUDNZD
6599,2010.04.06 16:30,close,3295,0.01,1.32088,12.78,21829.91,AUDNZD
6600,2010.04.06 16:30,close,3294,0.01,1.32088,12.79,21842.70,AUDNZD
6601,2010.04.06 16:30,close,3303,0.01,0.92320,5.33,21848.03,AUDUSD
6602,2010.04.06 16:30,close,3299,0.01,0.92320,5.10,21853.13,AUDUSD
6603,2010.04.06 16:30,close,3298,0.03,0.92320,15.27,21868.40,AUDUSD
6604,2010.04.06 16:30,close,3288,0.01,1.44928,15.00,21883.40,EURAUD
6605,2010.04.06 16:30,close,3283,0.01,1.44928,15.16,21898.56,EURAUD
6606,2010.04.06 16:30,close,3282,0.01,1.44928,15.17,21913.73,EURAUD
6607,2010.04.06 16:30,close,3281,0.01,1.44928,15.18,21928.91,EURAUD
6608,2010.04.06 16:30,close,3280,0.01,1.44928,15.19,21944.10,EURAUD